Name,Team,Pos,GP,G,A,P,PIM,X,TOIGP,TOIES,TOIPP,TOISH,ESG,PPG,SHG,GWG,OTG,SHOUTG,ESA,PPA,SHA,GWA,OTA,ESP,PPP,SHP,GWP,OTP,PPPPCT,GGP,AGP,PGP,SHOTS,SHPCT,HITS,BS
Connor McDavid,EDM,W,52,41,53,94,20,6,22:39,17:18,4:02,1:17,24,16,1,7,1,0,21,31,1,10,1,45,47,2,17,2,50.00%,0.788,1.019,1.808,217,18.90%,47,30
Leon Draisaitl,EDM,W,50,29,47,76,20,2,21:56,17:04,4:05,0:46,12,17,0,9,1,0,27,19,1,8,1,39,36,1,17,2,47.40%,0.58,0.94,1.52,148,19.60%,34,30
Nikita Kucherov,TBL,W,51,20,56,76,28,4,20:28,16:18,4:09,0:00,14,6,0,4,0,0,31,25,0,11,1,45,31,0,15,1,40.80%,0.392,1.098,1.49,171,11.70%,40,20
David Pastrnak,BOS,W,51,38,34,72,32,25,19:43,15:47,3:53,0:02,24,14,0,5,1,1,20,14,0,9,1,44,28,0,14,2,38.90%,0.745,0.667,1.412,245,15.50%,59,17
Matthew Tkachuk,FLA,W,51,27,44,71,74,15,20:16,15:38,4:09,0:28,17,10,0,2,0,0,28,15,1,7,0,45,25,1,9,0,35.20%,0.529,0.863,1.392,197,13.70%,34,24
Erik Karlsson,SJS,D,53,17,53,70,10,-3,25:26:00,21:56,3:18,0:12,13,4,0,4,2,0,39,14,0,4,1,52,18,0,8,3,25.70%,0.321,1,1.321,137,12.40%,25,58
Jason Robertson,DAL,W,53,33,36,69,14,29,18:49,15:41,3:07,0:00,26,7,0,5,0,3,19,17,0,5,0,45,24,0,10,0,34.80%,0.623,0.679,1.302,209,15.80%,33,10
Tage Thompson,BUF,W,50,34,34,68,24,15,18:55,14:36,3:27,0:51,19,14,1,6,1,1,23,11,0,4,3,42,25,1,10,4,36.80%,0.68,0.68,1.36,200,17.00%,24,17
Jack Hughes,NJD,C,50,35,32,67,4,15,20:10,16:48,3:17,0:04,29,6,0,5,1,0,18,14,0,10,6,47,20,0,15,7,29.90%,0.7,0.64,1.34,229,15.30%,11,13
Elias Pettersson,VAN,W,50,24,39,63,6,6,19:56,14:31,3:46,1:38,21,2,1,2,2,2,25,13,1,2,0,46,15,2,4,2,23.80%,0.48,0.78,1.26,164,14.60%,45,60
Kirill Kaprizov,MIN,W,51,29,33,62,37,-3,20:47,16:50,3:55,0:01,15,14,0,4,1,5,18,15,0,5,0,33,29,0,9,1,46.80%,0.569,0.647,1.216,191,15.20%,49,18
Sidney Crosby,PIT,C,51,24,38,62,26,6,20:12,16:14,3:53,0:03,19,5,0,6,0,1,26,12,0,8,3,45,17,0,14,3,27.40%,0.471,0.745,1.216,146,16.40%,51,27
Ryan Nugent-Hopkins,EDM,W,52,23,39,62,24,7,19:43,13:59,4:01,1:42,14,8,1,2,0,1,13,25,1,4,0,27,33,2,6,0,53.20%,0.442,0.75,1.192,124,18.60%,34,19
Mitchell Marner,TOR,W,53,19,43,62,18,5,21:10,14:52,3:47,2:30,11,6,2,4,2,1,22,20,1,9,0,33,26,3,13,2,41.90%,0.358,0.811,1.17,130,14.60%,43,31
Mikko Rantanen,COL,W,50,34,27,61,42,4,22:50,18:28,4:19,0:02,27,7,0,5,2,2,12,15,0,3,0,39,22,0,8,2,36.10%,0.68,0.54,1.22,189,18.00%,55,25
Zach Hyman,EDM,W,51,26,34,60,27,16,20:32,16:13,3:27,0:51,13,13,0,1,0,0,28,6,0,12,0,41,19,0,13,0,31.70%,0.51,0.667,1.176,195,13.30%,51,16
Brayden Point,TBL,W,51,32,27,59,7,8,19:46,15:49,3:55,0:01,21,11,0,7,1,1,19,8,0,6,1,40,19,0,13,2,32.20%,0.627,0.529,1.157,158,20.30%,18,20
William Nylander,TOR,W,53,28,31,59,14,14,18:37,14:35,3:47,0:14,21,7,0,4,2,0,19,12,0,7,1,40,19,0,11,3,32.20%,0.528,0.585,1.113,192,14.60%,14,14
Kyle Connor,WPG,W,52,24,35,59,10,6,20:31,16:38,3:29,0:23,18,6,0,8,2,0,21,14,0,4,0,39,20,0,12,2,33.90%,0.462,0.673,1.135,178,13.50%,32,16
Bo Horvat,NYI,W,52,33,24,57,12,5,20:40,15:10,3:52,1:38,19,11,3,4,1,0,15,8,1,2,0,34,19,4,6,1,33.30%,0.635,0.462,1.096,153,21.60%,41,33
Steven Stamkos,TBL,W,51,24,33,57,26,7,19:25,14:52,4:08,0:24,15,9,0,4,2,0,20,13,0,7,2,35,22,0,11,4,38.60%,0.471,0.647,1.118,177,13.60%,59,35
Alex Tuch,BUF,W,50,24,31,55,14,10,19:02,14:20,3:28,1:12,19,5,0,5,1,0,22,9,0,5,2,41,14,0,10,3,25.50%,0.48,0.62,1.1,149,16.10%,34,29
Nathan MacKinnon,COL,W,39,14,41,55,20,13,22:31,18:07,4:17,0:06,10,4,0,0,0,1,26,15,0,10,1,36,19,0,10,1,34.50%,0.359,1.051,1.41,202,6.90%,28,22
Rasmus Dahlin,BUF,D,49,14,41,55,64,19,26:07:00,20:39,3:52,1:35,9,5,0,2,0,0,22,19,0,7,3,31,24,0,9,3,43.60%,0.286,0.837,1.122,142,9.90%,66,87
Alexander Ovechkin,WSH,W,52,32,22,54,20,-2,20:31,15:29,5:00,0:01,22,10,0,3,1,0,14,8,0,5,0,36,18,0,8,1,33.30%,0.615,0.423,1.038,224,14.30%,134,15
Mika Zibanejad,NYR,C,52,26,28,54,8,16,20:48,14:44,3:55,2:08,10,15,1,4,0,1,20,8,0,7,3,30,23,1,11,3,42.60%,0.5,0.538,1.038,186,14.00%,43,24
Evgeni Malkin,PIT,C,51,19,35,54,30,-5,18:33,14:32,4:00,0:01,11,8,0,2,0,1,19,16,0,7,3,30,24,0,9,3,44.40%,0.373,0.686,1.059,152,12.50%,30,15
Artemi Panarin,NYR,W,52,12,42,54,22,-3,20:12,16:14,3:57,0:01,10,2,0,2,0,4,24,18,0,8,2,34,20,0,10,2,37.00%,0.231,0.808,1.038,133,9.00%,18,8
Auston Matthews,TOR,C,47,25,28,53,16,19,20:15,16:21,3:50,0:03,15,10,0,4,0,1,20,8,0,3,1,35,18,0,7,1,34.00%,0.532,0.596,1.128,200,12.50%,60,63
John Tavares,TOR,C,53,23,30,53,24,0,17:33,13:54,3:38,0:00,13,10,0,4,0,0,15,15,0,6,2,28,25,0,10,2,47.20%,0.434,0.566,1,190,12.10%,76,26
Kevin Fiala,LAK,W,53,18,35,53,38,-3,17:42,14:38,3:02,0:01,12,6,0,2,2,1,23,12,0,5,0,35,18,0,7,2,34.00%,0.34,0.66,1,163,11.00%,39,15
Josh Morrissey,WPG,D,52,10,43,53,27,7,23:39,19:45,3:30,0:23,9,1,0,5,2,0,22,21,0,8,2,31,22,0,13,4,41.50%,0.192,0.827,1.019,99,10.10%,63,74
Pierre-Luc Dubois,WPG,C,52,22,30,52,52,9,18:27,14:55,3:27,0:04,14,8,0,1,0,0,20,10,0,7,2,34,18,0,8,2,34.60%,0.423,0.577,1,148,14.90%,53,33
Jesper Bratt,NJD,W,51,20,32,52,4,20,17:39,14:36,3:00,0:02,13,7,0,3,1,0,20,12,0,8,1,33,19,0,11,2,36.50%,0.392,0.627,1.02,132,15.20%,15,17
Timo Meier,SJS,W,53,30,21,51,21,-16,19:59,16:49,3:00,0:09,17,13,0,4,1,0,16,5,0,4,2,33,18,0,8,3,35.30%,0.566,0.396,0.962,237,12.70%,109,20
Brady Tkachuk,OTT,W,50,20,31,51,68,-11,18:31,14:15,4:11,0:03,15,5,0,6,2,0,16,15,0,2,0,31,20,0,8,2,39.20%,0.4,0.62,1.02,209,9.60%,141,7
Dougie Hamilton,NJD,D,51,15,36,51,38,18,22:20,18:46,3:17,0:16,8,7,0,6,2,0,20,16,0,8,3,28,23,0,14,5,45.10%,0.294,0.706,1,184,8.20%,42,54
Jeff Skinner,BUF,W,47,20,30,50,29,14,17:25,13:57,3:25,0:02,14,6,0,0,0,0,22,8,0,5,0,36,14,0,5,0,28.00%,0.426,0.638,1.064,136,14.70%,17,12
Mats Zuccarello,MIN,W,49,19,31,50,22,-5,20:14,16:14,3:52,0:07,12,7,0,3,1,3,17,14,0,5,1,29,21,0,8,2,42.00%,0.388,0.633,1.02,135,14.10%,28,37
Adam Fox,NYR,D,52,10,40,50,20,25,25:00:00,18:56,3:51,2:12,9,1,0,4,1,0,23,16,1,5,0,32,17,1,9,1,34.00%,0.192,0.769,0.962,113,8.90%,18,72
Travis Konecny,PHI,W,47,24,25,49,65,-8,20:12,14:59,3:10,2:02,16,5,3,5,0,0,14,8,3,1,0,30,13,6,6,0,26.50%,0.511,0.532,1.043,153,15.70%,45,30
Roope Hintz,DAL,W,45,22,27,49,14,24,17:09,13:29,2:46,0:52,15,5,2,4,0,0,16,11,0,2,0,31,16,2,6,0,32.70%,0.489,0.6,1.089,112,19.60%,31,33
Tim Stützle,OTT,W,46,22,27,49,30,-8,20:37,15:44,3:48,1:04,14,8,0,1,0,0,15,12,0,6,2,29,20,0,7,2,40.80%,0.478,0.587,1.065,125,17.60%,73,33
Brock Nelson,NYI,W,55,20,29,49,20,0,18:41,14:43,3:08,0:48,17,3,0,5,0,0,21,8,0,6,1,38,11,0,11,1,22.40%,0.364,0.527,0.891,159,12.60%,40,32
Johnny Gaudreau,CBJ,W,52,14,35,49,18,-17,19:29,16:30,2:57,0:00,13,1,0,2,1,0,22,13,0,3,1,35,14,0,5,2,28.60%,0.269,0.673,0.942,136,10.30%,4,14
Quinton Hughes,VAN,D,48,5,44,49,16,13,24:49:00,19:47,4:00,1:00,3,2,0,0,0,0,22,22,0,7,3,25,24,0,7,3,49.00%,0.104,0.917,1.021,85,5.90%,11,47
Claude Giroux,OTT,W,50,20,28,48,12,-1,18:22,14:53,2:50,0:39,15,5,0,3,1,0,14,13,1,5,1,29,18,1,8,2,37.50%,0.4,0.56,0.96,121,16.50%,37,20
Joe Pavelski,DAL,W,53,14,34,48,8,32,17:37,14:34,2:54,0:07,7,7,0,0,0,1,25,9,0,7,0,32,16,0,7,0,33.30%,0.264,0.642,0.906,119,11.80%,59,47
Mathew Barzal,NYI,W,54,14,34,48,20,5,18:47,15:16,3:29,0:00,10,4,0,5,1,1,20,14,0,5,1,30,18,0,10,2,37.50%,0.259,0.63,0.889,128,10.90%,23,32
Mark Scheifele,WPG,C,52,31,16,47,35,-1,20:29,16:54,3:26,0:08,22,9,0,5,1,0,10,6,0,6,1,32,15,0,11,2,31.90%,0.596,0.308,0.904,136,22.80%,29,24
Carter Verhaeghe,FLA,W,53,28,19,47,32,9,17:24,15:16,2:06,0:01,22,6,0,1,0,0,16,3,0,2,0,38,9,0,3,0,19.10%,0.528,0.358,0.887,167,16.80%,21,22
Jordan Kyrou,STL,W,48,23,24,47,6,-25,18:14,15:24,2:49,0:00,14,9,0,3,1,1,15,8,1,5,2,29,17,1,8,3,36.20%,0.479,0.5,0.979,169,13.60%,10,24
Jake Guentzel,PIT,W,47,21,26,47,34,5,20:07,16:19,3:45,0:03,16,5,0,5,1,0,20,6,0,4,0,36,11,0,9,1,23.40%,0.447,0.553,1,147,14.30%,52,21
Nico Hischier,NJD,C,50,21,26,47,4,21,19:21,13:51,3:11,2:17,14,6,1,5,1,0,17,8,1,5,1,31,14,2,10,2,29.80%,0.42,0.52,0.94,155,13.60%,16,35
Martin Necas,CAR,W,51,21,26,47,24,8,19:00,14:59,3:19,0:41,15,6,0,4,3,0,15,10,1,8,2,30,16,1,12,5,34.00%,0.412,0.51,0.922,165,12.70%,35,11
J.T. Miller,VAN,W,52,18,29,47,38,-13,20:35,15:06,3:58,1:30,10,8,0,1,0,1,15,14,0,3,2,25,22,0,4,2,46.80%,0.346,0.558,0.904,138,13.00%,104,34
Aleksander Barkov,FLA,W,43,14,33,47,2,5,21:08,15:01,4:06,2:00,7,7,0,3,0,0,18,14,1,5,1,25,21,1,8,1,44.70%,0.326,0.767,1.093,128,10.90%,26,31
Sebastian AhoCAR,CAR,C,44,23,23,46,22,9,19:36,14:04,3:33,1:59,15,5,3,5,1,1,15,7,1,3,1,30,12,4,8,2,26.10%,0.523,0.523,1.045,138,16.70%,39,15
Brad Marchand,BOS,W,43,16,30,46,38,18,18:53,13:54,3:31,1:27,8,8,0,2,0,0,15,15,0,10,1,23,23,0,12,1,50.00%,0.372,0.698,1.07,114,14.00%,53,14
Kevin Hayes,PHI,W,52,16,30,46,19,-7,18:03,14:45,3:06,0:12,10,6,0,1,0,0,21,9,0,3,0,31,15,0,4,0,32.60%,0.308,0.577,0.885,150,10.70%,33,15
Elias Lindholm,CGY,W,51,15,31,46,8,1,18:54,13:25,3:04,2:24,8,7,0,1,0,0,22,8,1,3,0,30,15,1,4,0,32.60%,0.294,0.608,0.902,111,13.50%,54,28
Chandler Stephenson,VGK,W,53,12,34,46,18,8,19:43,15:40,2:33,1:29,6,5,1,4,0,1,25,7,2,6,1,31,12,3,10,1,26.10%,0.226,0.642,0.868,78,15.40%,58,37
Jamie Benn,DAL,W,53,20,25,45,20,16,15:26,11:41,2:45,0:59,9,10,1,2,0,0,16,8,1,3,0,25,18,2,5,0,40.00%,0.377,0.472,0.849,125,16.00%,60,25
Clayton Keller,ARI,W,52,19,26,45,35,-12,20:37,16:56,3:16,0:24,15,4,0,3,1,1,18,8,0,5,0,33,12,0,8,1,26.70%,0.365,0.5,0.865,120,15.80%,11,18
Dylan Larkin,DET,W,49,16,29,45,12,0,19:53,14:23,3:40,1:49,7,8,1,2,0,1,22,7,0,3,0,29,15,1,5,0,33.30%,0.327,0.592,0.918,154,10.40%,31,19
Tomas Hertl,SJS,W,51,14,31,45,22,-11,19:19,16:10,2:54,0:14,10,4,0,1,0,0,22,9,0,3,2,32,13,0,4,2,28.90%,0.275,0.608,0.882,117,12.00%,59,40
Cale Makar,COL,D,45,13,32,45,26,5,27:03:00,20:06,4:11,2:45,8,5,0,3,1,0,16,16,0,4,1,24,21,0,7,2,46.70%,0.289,0.711,1,141,9.20%,58,61
Andrei Kuzmenko,VAN,W,51,22,22,44,6,3,15:51,12:56,2:54,0:00,13,9,0,2,1,2,20,2,0,4,1,33,11,0,6,2,25.00%,0.431,0.431,0.863,90,24.40%,10,13
Brandon Hagel,TBL,W,51,21,23,44,36,14,18:50,14:20,2:43,1:46,14,6,1,1,0,0,18,5,0,5,0,32,11,1,6,0,25.00%,0.412,0.451,0.863,112,18.80%,38,39
Trevor Zegras,ANA,W,53,19,25,44,56,-24,19:28,16:26,3:00,0:01,15,4,0,3,2,4,16,9,0,3,1,31,13,0,6,3,29.50%,0.358,0.472,0.83,131,14.50%,34,20
Brandon Montour,FLA,D,52,10,34,44,83,-1,24:14:00,18:56,4:11,1:06,7,3,0,3,0,0,19,15,0,6,0,26,18,0,9,0,40.90%,0.192,0.654,0.846,147,6.80%,72,60
Joel Eriksson Ek,MIN,C,51,19,24,43,30,-3,19:14,13:25,3:37,2:11,8,9,2,0,0,0,14,9,1,3,0,22,18,3,3,0,41.90%,0.373,0.471,0.843,159,12.00%,71,33
Tyler Toffoli,CGY,W,52,19,24,43,20,7,16:51,13:08,3:05,0:38,12,7,0,2,1,0,15,9,0,4,1,27,16,0,6,2,37.20%,0.365,0.462,0.827,158,12.00%,47,8
Logan Couture,SJS,W,53,19,24,43,11,-19,18:39,13:34,2:56,2:09,15,3,1,1,0,1,13,11,0,4,0,28,14,1,5,0,32.60%,0.358,0.453,0.811,126,15.10%,83,49
Dylan Cozens,BUF,W,49,17,26,43,24,3,16:36,12:09,2:57,1:29,12,3,2,1,1,0,14,11,1,3,1,26,14,3,4,2,32.60%,0.347,0.531,0.878,124,13.70%,39,19
Anze Kopitar,LAK,C,53,16,27,43,4,3,20:20,15:26,3:06,1:47,12,4,0,1,0,0,19,7,1,5,0,31,11,1,6,0,25.60%,0.302,0.509,0.811,110,14.60%,56,61
Drake Batherson,OTT,W,50,15,28,43,20,-30,18:31,14:39,3:50,0:01,4,11,0,1,0,0,17,11,0,3,0,21,22,0,4,0,51.20%,0.3,0.56,0.86,146,10.30%,80,20
Robert Thomas,STL,C,48,12,31,43,14,-2,19:09,15:16,2:58,0:54,9,3,0,2,1,1,20,11,0,6,1,29,14,0,8,2,32.60%,0.25,0.646,0.896,73,16.40%,11,22
Evgeny Kuznetsov,WSH,W,52,7,36,43,36,-3,18:19,14:10,3:09,0:59,3,4,0,2,1,3,24,12,0,5,1,27,16,0,7,2,37.20%,0.135,0.692,0.827,120,5.80%,30,19
Filip Forsberg,NSH,W,49,19,23,42,20,-4,17:43,14:32,3:09,0:01,15,4,0,2,0,1,14,9,0,2,0,29,13,0,4,0,31.00%,0.388,0.469,0.857,157,12.10%,84,19
Andrei Svechnikov,CAR,W,51,19,23,42,55,-2,18:05,14:44,3:19,0:01,15,4,0,1,0,4,13,10,0,6,3,28,14,0,7,3,33.30%,0.373,0.451,0.824,169,11.20%,105,14
Troy Terry,ANA,W,51,13,29,42,16,-13,19:25,16:24,2:52,0:08,9,4,0,2,1,2,22,7,0,3,1,31,11,0,5,2,26.20%,0.255,0.569,0.824,146,8.90%,12,17
David Krejcí,BOS,W,46,12,30,42,10,16,17:03,14:18,2:37,0:07,9,3,0,1,0,0,23,7,0,8,1,32,10,0,9,1,23.80%,0.261,0.652,0.913,70,17.10%,31,30
Roman Josi,NSH,D,49,12,30,42,24,3,25:06:00,20:43,3:28,0:54,6,6,0,4,1,0,18,12,0,4,0,24,18,0,8,1,42.90%,0.245,0.612,0.857,205,5.90%,38,111
Sam Reinhart,FLA,W,54,19,22,41,8,-11,19:32,14:04,3:59,1:29,11,8,0,3,1,1,11,9,2,5,0,22,17,2,8,1,41.50%,0.352,0.407,0.759,142,13.40%,31,31
Alex DeBrincat,OTT,W,50,17,24,41,22,-16,19:22,15:07,4:11,0:03,10,7,0,3,1,1,10,14,0,2,0,20,21,0,5,1,51.20%,0.34,0.48,0.82,172,9.90%,85,20
Nicholas Suzuki,MTL,W,51,16,24,40,16,-15,21:22,16:07,3:40,1:35,10,5,1,0,0,4,17,7,0,4,1,27,12,1,4,1,30.00%,0.314,0.471,0.784,98,16.30%,30,33
Miro Heiskanen,DAL,D,50,7,33,40,20,11,25:19:00,20:18,3:00,1:59,6,1,0,0,0,0,15,17,1,4,0,21,18,1,4,0,45.00%,0.14,0.66,0.8,134,5.20%,32,61
Matt Duchene,NSH,W,48,15,24,39,28,2,17:59,14:58,2:59,0:00,11,4,0,2,0,2,20,4,0,7,2,31,8,0,9,2,20.50%,0.313,0.5,0.813,110,13.60%,17,21
Andre Burakovsky,SEA,W,49,13,26,39,14,-9,16:33,13:58,2:35,0:00,9,4,0,3,2,0,16,10,0,3,1,25,14,0,6,3,35.90%,0.265,0.531,0.796,105,12.40%,17,15
Vince Dunn,SEA,D,52,9,30,39,27,24,23:56,20:27,2:46,0:42,9,0,0,1,0,0,20,10,0,7,3,29,10,0,8,3,25.60%,0.173,0.577,0.75,94,9.60%,86,57
Nazem Kadri,CGY,W,52,19,19,38,36,-10,17:41,14:25,3:09,0:07,10,9,0,3,0,0,13,6,0,5,0,23,15,0,8,0,39.50%,0.365,0.365,0.731,169,11.20%,55,23
Patrice Bergeron,BOS,W,51,18,20,38,14,21,17:52,12:38,3:26,1:47,12,6,0,5,0,0,13,7,0,4,2,25,13,0,9,2,34.20%,0.353,0.392,0.745,171,10.50%,46,41
Mark Stone,VGK,W,43,17,21,38,10,11,19:22,15:27,2:43,1:11,12,3,2,1,0,1,15,6,0,7,2,27,9,2,8,2,23.70%,0.395,0.488,0.884,113,15.00%,31,23
Pavel Buchnevich,STL,W,38,15,23,38,20,-1,19:28,14:50,3:02,1:34,8,7,0,2,0,2,13,10,0,4,0,21,17,0,6,0,44.70%,0.395,0.605,1,72,20.80%,37,11
Jordan Eberle,SEA,W,52,10,28,38,24,1,16:27,13:50,2:36,0:01,8,2,0,2,1,1,21,7,0,7,2,29,9,0,9,3,23.70%,0.192,0.538,0.731,111,9.00%,26,15
Matthew Boldy,MIN,W,51,16,21,37,28,-7,17:52,13:50,3:51,0:10,9,7,0,3,0,1,9,12,0,5,1,18,19,0,8,1,51.40%,0.314,0.412,0.725,160,10.00%,45,16
Vincent Trocheck,NYR,C,52,15,22,37,34,-5,19:59,15:29,3:47,0:42,7,8,0,2,0,0,16,6,0,6,0,23,14,0,8,0,37.80%,0.288,0.423,0.712,154,9.70%,125,24
Alex Killorn,TBL,W,51,14,23,37,24,11,17:11,13:26,1:48,1:55,14,0,0,4,2,1,19,4,0,1,0,33,4,0,5,2,10.80%,0.275,0.451,0.725,85,16.50%,35,18
Brayden Schenn,STL,W,51,13,24,37,27,-27,18:07,15:16,2:23,0:27,10,3,0,1,1,1,17,7,0,4,0,27,10,0,5,1,27.00%,0.255,0.471,0.725,93,14.00%,90,18
Blake Wheeler,WPG,W,43,12,25,37,28,5,17:17,14:07,2:33,0:36,6,6,0,5,1,0,21,4,0,4,1,27,10,0,9,2,27.00%,0.279,0.581,0.86,80,15.00%,30,17
Brent Burns,CAR,D,51,10,27,37,38,7,23:23,17:45,3:22,2:15,8,2,0,1,1,1,13,14,0,7,2,21,16,0,8,3,43.20%,0.196,0.529,0.725,158,6.30%,30,61
Cole Caufield,MTL,W,46,26,10,36,2,-10,18:02,14:46,3:15,0:00,19,7,0,3,0,2,7,3,0,1,0,26,10,0,4,0,27.80%,0.565,0.217,0.783,158,16.50%,18,12
Jared McCann,SEA,W,49,24,12,36,10,4,15:27,12:21,2:30,0:35,20,4,0,2,0,0,6,6,0,3,0,26,10,0,5,0,27.80%,0.49,0.245,0.735,106,22.60%,42,12
Adrian Kempe,LAK,W,53,22,14,36,26,4,18:52,14:17,2:59,1:34,15,6,1,4,1,2,9,5,0,0,0,24,11,1,4,1,30.60%,0.415,0.264,0.679,151,14.60%,74,22
Anders Lee,NYI,W,55,19,17,36,42,3,16:55,13:38,3:16,0:00,15,4,0,2,0,0,11,6,0,0,0,26,10,0,2,0,27.80%,0.345,0.309,0.655,145,13.10%,84,37
Matthew Beniers,SEA,W,50,17,19,36,2,5,16:59,14:19,2:22,0:17,13,4,0,3,1,0,16,3,0,5,0,29,7,0,8,1,19.40%,0.34,0.38,0.72,96,17.70%,60,35
Jack Eichel,VGK,W,40,16,20,36,4,10,18:44,15:25,2:48,0:29,15,1,0,2,1,0,12,8,0,4,1,27,9,0,6,2,25.00%,0.4,0.5,0.9,144,11.10%,31,31
Michael Bunting,TOR,W,53,15,21,36,62,20,16:17,14:16,2:01,0:00,11,4,0,2,0,0,18,3,0,5,0,29,7,0,7,0,19.40%,0.283,0.396,0.679,110,13.60%,49,14
Phillip Danault,LAK,C,53,14,22,36,49,-7,18:15,14:20,2:09,1:45,11,3,0,1,1,0,11,9,2,5,1,22,12,2,6,2,33.30%,0.264,0.415,0.679,103,13.60%,50,53
Dylan Strome,WSH,W,52,11,25,36,16,-7,16:42,13:16,3:25,0:00,8,3,0,2,0,0,14,11,0,4,1,22,14,0,6,1,38.90%,0.212,0.481,0.692,90,12.20%,10,28
Mikhail Sergachyov,TBL,D,49,7,29,36,38,11,23:49,18:59,2:18,2:30,5,2,0,1,0,0,15,13,1,9,1,20,15,1,10,1,41.70%,0.143,0.592,0.735,89,7.90%,65,102
Chris Kreider,NYR,W,49,21,14,35,16,13,19:08,13:29,3:49,1:49,15,4,2,2,1,0,6,8,0,3,0,21,12,2,5,1,34.30%,0.429,0.286,0.714,159,13.20%,80,16
Max Domi,CHI,C,50,14,21,35,58,-13,18:17,15:00,3:15,0:01,7,7,0,3,2,0,14,7,0,1,0,21,14,0,4,2,40.00%,0.28,0.42,0.7,112,12.50%,12,12
Tyler Seguin,DAL,W,53,14,21,35,22,8,16:47,13:40,2:04,1:02,10,4,0,3,1,1,19,2,0,3,0,29,6,0,6,1,17.10%,0.264,0.396,0.66,127,11.00%,54,18
Pavel Zacha,BOS,W,51,11,24,35,10,16,15:43,12:50,1:32,1:21,10,1,0,1,0,0,21,2,1,9,0,31,3,1,10,0,8.60%,0.216,0.471,0.686,83,13.30%,43,14
William Karlsson,VGK,W,53,11,24,35,6,2,17:40,14:31,1:38,1:30,9,2,0,2,0,0,15,6,3,2,1,24,8,3,4,1,22.90%,0.208,0.453,0.66,105,10.50%,38,30
Brock Boeser,VAN,W,44,10,25,35,16,-13,16:46,14:08,2:37,0:00,7,3,0,2,0,0,20,5,0,4,0,27,8,0,6,0,22.90%,0.227,0.568,0.795,98,10.20%,25,21
Patrick Kane,CHI,W,47,9,26,35,10,-25,19:53,16:16,3:36,0:00,7,2,0,0,0,0,12,14,0,1,0,19,16,0,1,0,45.70%,0.191,0.553,0.745,156,5.80%,8,8
Tyson Barrie,EDM,D,52,7,28,35,24,-2,19:20,15:19,3:14,0:46,4,3,0,0,0,0,8,20,0,0,0,12,23,0,0,0,65.70%,0.135,0.538,0.673,94,7.50%,37,62
Reilly Smith,VGK,W,53,19,15,34,16,0,17:11,13:54,2:01,1:16,9,6,4,3,1,1,14,1,0,2,0,23,7,4,5,1,20.60%,0.358,0.283,0.642,134,14.20%,51,21
Artturi Lehkonen,COL,W,47,15,19,34,20,3,21:32,16:04,3:54,1:33,7,7,1,3,1,0,10,9,0,4,0,17,16,1,7,1,47.10%,0.319,0.404,0.723,109,13.80%,63,32
Jonathan Marchessault,VGK,W,47,15,19,34,9,-4,16:59,14:28,2:31,0:00,8,7,0,2,1,1,13,6,0,0,0,21,13,0,2,1,38.20%,0.319,0.404,0.723,155,9.70%,49,8
Dominik Kubalik,DET,W,49,14,20,34,12,-9,15:11,12:06,3:04,0:00,7,7,0,1,1,0,12,8,0,4,0,19,15,0,5,1,44.10%,0.286,0.408,0.694,118,11.90%,48,15
Viktor Arvidsson,LAK,W,48,13,21,34,10,-7,16:52,14:33,2:16,0:02,8,4,1,2,0,1,13,8,0,3,1,21,12,1,5,1,35.30%,0.271,0.438,0.708,119,10.90%,12,25
Sam Bennett,FLA,W,53,13,21,34,52,1,17:42,14:13,2:08,1:21,9,4,0,3,0,0,16,5,0,2,0,25,9,0,5,0,26.50%,0.245,0.396,0.642,160,8.10%,126,34
Rasmus Andersson,CGY,D,51,7,27,34,18,6,24:40:00,18:59,3:06,2:35,7,0,0,4,1,2,11,15,1,5,1,18,15,1,9,2,44.10%,0.137,0.529,0.667,111,6.30%,40,89
Victor Hedman,TBL,D,48,4,30,34,22,11,24:16:00,19:22,3:02,1:51,4,0,0,1,0,0,18,11,1,2,0,22,11,1,3,0,32.40%,0.083,0.625,0.708,104,3.90%,61,84
Filip Chytil,NYR,C,44,19,14,33,26,17,14:28,13:10,1:15,0:02,16,3,0,2,1,0,13,1,0,2,0,29,4,0,4,1,12.10%,0.432,0.318,0.75,97,19.60%,31,26
Adam Henrique,ANA,W,52,19,14,33,22,-2,18:24,13:34,2:33,2:17,16,3,0,1,0,1,8,6,0,0,0,24,9,0,1,0,27.30%,0.365,0.269,0.635,105,18.10%,27,41
Rickard Rakell,PIT,W,51,18,15,33,10,-1,18:26,15:29,2:56,0:00,10,8,0,1,0,2,11,4,0,4,1,21,12,0,5,1,36.40%,0.353,0.294,0.647,154,11.70%,82,34
Lucas Raymond,DET,W,50,15,18,33,22,-10,17:20,14:19,2:58,0:02,10,5,0,3,0,0,9,9,0,0,0,19,14,0,3,0,42.40%,0.3,0.36,0.66,87,17.20%,24,15
Bryan Rust,PIT,W,51,13,20,33,17,-5,17:41,14:08,2:18,1:14,11,2,0,0,0,0,12,7,1,3,0,23,9,1,3,0,27.30%,0.255,0.392,0.647,133,9.80%,57,22
Kirby Dach,MTL,W,51,11,22,33,43,-6,18:17,14:40,3:22,0:13,6,5,0,2,1,2,12,9,1,5,2,18,14,1,7,3,42.40%,0.216,0.431,0.647,96,11.50%,43,35
Jonathan Huberdeau,CGY,W,49,10,23,33,28,-1,16:55,13:41,3:02,0:11,7,3,0,1,0,3,15,8,0,4,1,22,11,0,5,1,33.30%,0.204,0.469,0.673,79,12.70%,44,20
Alexander Barabanov,SJS,W,48,8,25,33,12,-20,17:48,15:05,2:42,0:00,7,1,0,1,0,1,16,9,0,5,0,23,10,0,6,0,30.30%,0.167,0.521,0.688,86,9.30%,28,27
Alex Pietrangelo,VGK,D,44,7,26,33,10,-1,24:26:00,19:25,2:41,2:19,6,1,0,2,0,0,16,10,0,6,1,22,11,0,8,1,33.30%,0.159,0.591,0.75,111,6.30%,44,120
Filip Hronek,DET,D,50,7,26,33,28,11,21:48,17:42,2:28,1:37,4,3,0,1,0,0,16,10,0,2,0,20,13,0,3,0,39.40%,0.14,0.52,0.66,112,6.30%,86,41
Hampus Lindholm,BOS,D,51,6,27,33,36,33,23:34,19:02,2:15,2:16,6,0,0,2,1,0,18,9,0,4,0,24,9,0,6,1,27.30%,0.118,0.529,0.647,111,5.40%,49,66
Drew Doughty,LAK,D,52,3,30,33,30,3,26:10:00,20:41,3:10,2:19,1,2,0,1,0,0,16,14,0,4,0,17,16,0,5,0,48.50%,0.058,0.577,0.635,93,3.20%,75,78
Taylor Hall,BOS,W,51,15,17,32,20,11,16:02,13:41,2:20,0:00,11,4,0,5,1,1,15,2,0,3,0,26,6,0,8,1,18.80%,0.294,0.333,0.627,127,11.80%,30,28
Mikael Backlund,CGY,W,52,9,23,32,28,14,17:34,13:36,1:46,2:12,7,1,1,1,0,0,21,1,1,3,0,28,2,2,4,0,6.30%,0.173,0.442,0.615,158,5.70%,56,16
Yanni Gourde,SEA,W,51,6,26,32,48,17,16:57,14:44,0:07,2:05,5,0,1,1,0,0,26,0,0,2,0,31,0,1,3,0,0.00%,0.118,0.51,0.627,85,7.10%,79,28
Charlie McAvoy,BOS,D,38,4,28,32,28,21,22:37,17:47,2:45,2:04,3,1,0,1,0,0,13,15,0,4,0,16,16,0,5,0,50.00%,0.105,0.737,0.842,64,6.30%,49,70
Gabriel Vilardi,LAK,W,45,17,14,31,10,6,15:47,12:44,3:02,0:01,13,4,0,3,0,2,10,4,0,1,0,23,8,0,4,0,25.80%,0.378,0.311,0.689,88,19.30%,33,24
Patrik Laine,CBJ,W,37,14,17,31,12,-10,19:26,16:12,3:13,0:00,12,2,0,1,0,1,11,6,0,2,1,23,8,0,3,1,25.80%,0.378,0.459,0.838,128,10.90%,19,18
David Perron,DET,W,50,14,17,31,30,0,16:45,13:15,3:29,0:00,11,3,0,2,0,1,9,8,0,4,1,20,11,0,6,1,35.50%,0.28,0.34,0.62,122,11.50%,64,14
Jason Zucker,PIT,W,47,13,18,31,21,-1,15:36,14:11,1:25,0:00,12,1,0,2,0,0,12,6,0,1,0,24,7,0,3,0,22.60%,0.277,0.383,0.66,112,11.60%,130,17
Anthony DeAngelo,PHI,D,48,9,22,31,52,-16,22:56,18:02,3:23,1:30,6,3,0,1,1,0,10,12,0,0,0,16,15,0,1,1,48.40%,0.188,0.458,0.646,120,7.50%,40,54
Jake DeBrusk,BOS,W,36,16,14,30,8,15,17:08,12:34,3:05,1:27,11,5,0,4,0,2,7,6,1,1,0,18,11,1,5,0,36.70%,0.444,0.389,0.833,109,14.70%,51,14
Nick Schmaltz,ARI,W,36,12,18,30,10,-3,19:27,15:58,3:00,0:29,9,3,0,2,0,1,15,3,0,2,1,24,6,0,4,1,20.00%,0.333,0.5,0.833,74,16.20%,5,17
Scott Laughton,PHI,W,49,12,18,30,20,-5,18:57,14:14,2:20,2:22,4,5,3,0,0,0,11,3,4,3,0,15,8,7,3,0,26.70%,0.245,0.367,0.612,107,11.20%,107,33
Conor Sheary,WSH,W,53,12,18,30,18,5,15:59,13:08,1:14,1:36,8,2,2,1,0,0,13,5,0,1,0,21,7,2,2,0,23.30%,0.226,0.34,0.566,106,11.30%,39,23
Vladimir Tarasenko,NYR,W,39,11,19,30,8,-17,17:25,14:38,2:45,0:01,8,2,1,0,0,1,12,7,0,4,2,20,9,1,4,2,30.00%,0.282,0.487,0.769,105,10.50%,45,17
Noah Dobson,NYI,D,51,11,19,30,12,-4,20:57,16:53,3:29,0:34,7,4,0,2,1,0,11,8,0,3,1,18,12,0,5,2,40.00%,0.216,0.373,0.588,140,7.90%,43,80
Mason McTavish,ANA,W,52,11,19,30,36,-10,15:16,12:38,2:34,0:03,7,4,0,1,0,2,12,7,0,2,1,19,11,0,3,1,36.70%,0.212,0.365,0.577,113,9.70%,44,30
J.T. Compher,COL,W,50,10,20,30,12,0,20:18,15:35,2:26,2:17,6,4,0,3,0,0,15,5,0,3,1,21,9,0,6,1,30.00%,0.2,0.4,0.6,95,10.50%,26,53
Gustav Forsling,FLA,D,54,7,23,30,28,16,23:42,19:13,1:28,3:00,6,1,0,2,0,0,18,4,1,2,0,24,5,1,4,0,16.70%,0.13,0.426,0.556,136,5.20%,50,70
Victor Olofsson,BUF,W,50,23,6,29,4,-8,14:34,12:08,2:24,0:01,18,5,0,5,2,0,4,2,0,2,0,22,7,0,7,2,24.10%,0.46,0.12,0.58,119,19.30%,10,10
Daniel Sprong,SEA,W,44,15,14,29,10,9,11:26,9:15,2:10,0:00,10,5,0,2,0,0,9,5,0,3,0,19,10,0,5,0,34.50%,0.341,0.318,0.659,97,15.50%,21,12
Dawson Mercer,NJD,C,51,11,18,29,12,9,15:26,13:02,1:16,1:08,9,1,1,3,0,0,14,3,1,0,0,23,4,2,3,0,13.80%,0.216,0.353,0.569,87,12.60%,22,40
Jean-Gabriel Pageau,NYI,W,55,10,19,29,8,-7,18:05,13:17,2:40,2:08,3,5,2,2,0,0,16,3,0,8,2,19,8,2,10,2,27.60%,0.182,0.345,0.527,96,10.40%,141,47
Shayne Gostisbehere,ARI,D,48,9,20,29,28,-8,22:38,18:38,3:13,0:46,5,3,1,1,0,0,13,7,0,1,0,18,10,1,2,0,34.50%,0.188,0.417,0.604,99,9.10%,34,67
Thomas Chabot,OTT,D,45,8,21,29,38,-10,25:47:00,21:32,4:02,0:12,3,5,0,0,0,0,11,10,0,4,3,14,15,0,4,3,51.70%,0.178,0.467,0.644,122,6.60%,51,75
Cole Perfetti,WPG,W,47,7,22,29,16,10,14:54,13:14,1:39,0:00,6,1,0,0,0,0,18,4,0,3,0,24,5,0,3,0,17.20%,0.149,0.468,0.617,83,8.40%,32,21
Erik Gustafsson,WSH,D,52,7,22,29,19,9,20:01,17:43,2:07,0:11,7,0,0,2,0,0,16,6,0,7,3,23,6,0,9,3,20.70%,0.135,0.423,0.558,99,7.10%,43,47
Lawson Crouse,ARI,W,47,16,12,28,22,0,17:52,13:43,1:56,2:12,13,3,0,1,0,0,12,0,0,3,0,25,3,0,4,0,10.70%,0.34,0.255,0.596,85,18.80%,109,34
Jonathan Toews,CHI,C,46,14,14,28,37,-24,17:55,13:39,3:04,1:11,6,8,0,1,1,1,11,3,0,1,0,17,11,0,2,1,39.30%,0.304,0.304,0.609,79,17.70%,6,22
Owen Tippett,PHI,W,48,14,14,28,14,-8,15:56,13:27,2:24,0:04,10,4,0,1,0,0,12,2,0,5,1,22,6,0,6,1,21.40%,0.292,0.292,0.583,123,11.40%,83,39
Ilya Mikheyev,VAN,W,46,13,15,28,2,3,16:54,14:01,1:29,1:24,12,1,0,2,0,0,13,2,0,1,0,25,3,0,3,0,10.70%,0.283,0.326,0.609,91,14.30%,13,14
Charlie Coyle,BOS,W,51,11,17,28,20,19,16:52,13:29,0:45,2:37,10,0,1,0,0,0,15,0,2,1,0,25,0,3,1,0,0.00%,0.216,0.333,0.549,95,11.60%,44,39
Andrew Mangiapane,CGY,W,52,11,17,28,22,4,16:35,13:25,1:57,1:12,11,0,0,1,0,0,14,1,2,3,1,25,1,2,4,1,3.60%,0.212,0.327,0.538,113,9.70%,69,19
Tomas Tatar,NJD,W,51,10,18,28,20,26,15:16,13:22,1:54,0:00,9,1,0,0,0,1,16,2,0,2,0,25,3,0,2,0,10.70%,0.196,0.353,0.549,94,10.60%,41,23
Oliver Bjorkstrand,SEA,W,52,10,18,28,8,7,15:29,13:20,2:08,0:00,9,1,0,0,0,0,15,3,0,0,0,24,4,0,0,0,14.30%,0.192,0.346,0.538,133,7.50%,39,30
Jakob Chychrun,ARI,D,36,7,21,28,22,8,23:16,19:41,2:59,0:35,3,4,0,0,0,0,18,3,0,3,1,21,7,0,3,1,25.00%,0.194,0.583,0.778,114,6.10%,43,56
Casey Mittelstadt,BUF,W,50,7,21,28,10,-13,15:36,12:48,2:14,0:33,2,4,1,0,0,0,13,8,0,1,0,15,12,1,1,0,42.90%,0.14,0.42,0.56,76,9.20%,19,10
Mikael Granlund,NSH,W,49,6,22,28,10,-15,18:41,14:49,3:01,0:50,5,1,0,0,0,0,14,8,0,2,1,19,9,0,2,1,32.10%,0.122,0.449,0.571,62,9.70%,50,37
K'Andre Miller,NYR,D,52,5,23,28,18,4,22:17,19:45,0:25,2:06,5,0,0,1,0,0,18,3,2,4,1,23,3,2,5,1,10.70%,0.096,0.442,0.538,79,6.30%,120,63
Marcus Johansson,WSH,W,53,13,14,27,8,4,15:55,12:31,2:49,0:34,8,4,1,5,1,0,6,8,0,2,2,14,12,1,7,3,44.40%,0.245,0.264,0.509,87,14.90%,19,11
Dillon Dube,CGY,W,52,12,15,27,41,-1,15:35,12:45,1:27,1:22,10,0,2,3,1,0,14,1,0,2,0,24,1,2,5,1,3.70%,0.231,0.288,0.519,91,13.20%,85,14
Conor Garland,VAN,W,51,10,17,27,27,-6,15:20,13:45,1:33,0:01,9,1,0,1,0,0,12,5,0,1,0,21,6,0,2,0,22.20%,0.196,0.333,0.529,105,9.50%,30,13
Kaapo Kakko,NYR,W,52,10,17,27,8,9,15:53,14:21,1:04,0:27,10,0,0,1,0,1,14,3,0,3,0,24,3,0,4,0,11.10%,0.192,0.327,0.519,84,11.90%,21,23
Jack Roslovic,CBJ,C,49,4,23,27,8,-8,16:44,12:45,2:13,1:45,1,1,2,0,0,0,18,4,1,4,0,19,5,3,4,0,18.50%,0.082,0.469,0.551,74,5.40%,27,31
Devon Toews,COL,D,48,3,24,27,10,13,25:22:00,20:21,1:43,3:17,3,0,0,0,0,0,22,2,0,2,2,25,2,0,2,2,7.40%,0.063,0.5,0.563,92,3.30%,53,85
Nick Paul,TBL,W,50,16,10,26,23,10,16:20,13:21,1:10,1:48,11,4,1,4,0,0,10,0,0,1,1,21,4,1,5,1,15.40%,0.32,0.2,0.52,80,20.00%,72,38
Boone Jenner,CBJ,C,41,14,12,26,26,-11,20:02,16:39,2:40,0:42,9,5,0,1,0,0,10,2,0,0,0,19,7,0,1,0,26.90%,0.341,0.293,0.634,126,11.10%,77,46
Blake Coleman,CGY,W,52,12,14,26,36,10,15:01,13:26,0:07,1:27,11,0,1,1,0,0,14,0,0,2,0,25,0,1,3,0,0.00%,0.231,0.269,0.5,127,9.50%,69,28
Evan Rodrigues,COL,W,39,11,15,26,16,4,19:03,15:39,2:35,0:49,6,5,0,1,0,2,12,3,0,4,1,18,8,0,5,1,30.80%,0.282,0.385,0.667,120,9.20%,22,12
Aaron Ekblad,FLA,D,43,8,18,26,46,-11,23:29,17:13,3:26,2:50,3,4,1,1,0,0,9,9,0,4,0,12,13,1,5,0,50.00%,0.186,0.419,0.605,124,6.50%,43,54
Cam Fowler,ANA,D,53,7,19,26,6,-16,24:04:00,19:19,2:34,2:10,3,4,0,1,0,0,12,7,0,2,1,15,11,0,3,1,42.30%,0.132,0.358,0.491,88,8.00%,12,54
Sean Durzi,LAK,D,50,6,20,26,31,-14,19:59,16:21,2:16,1:21,5,1,0,1,0,0,9,11,0,4,0,14,12,0,5,0,46.20%,0.12,0.4,0.52,79,7.60%,49,95
Justin Faulk,STL,D,51,6,20,26,18,-11,23:52,19:36,2:25,1:50,4,2,0,2,1,0,15,5,0,0,0,19,7,0,2,1,26.90%,0.118,0.392,0.51,122,4.90%,86,84
Andrew Copp,DET,W,50,5,21,26,15,2,17:31,13:41,1:42,2:07,4,1,0,2,1,0,20,1,0,2,1,24,2,0,4,2,7.70%,0.1,0.42,0.52,71,7.00%,23,26
Moritz Seider,DET,D,50,3,23,26,22,-12,23:04,17:29,3:08,2:26,2,1,0,1,0,0,13,9,1,2,2,15,10,1,3,2,38.50%,0.06,0.46,0.52,84,3.60%,117,121
Jordan Staal,CAR,C,50,14,11,25,16,8,16:27,13:45,0:09,2:32,13,0,1,3,0,0,10,0,1,2,0,23,0,2,5,0,0.00%,0.28,0.22,0.5,74,18.90%,100,27
Calle Järnkrok,TOR,W,46,12,13,25,12,5,13:39,10:53,1:09,1:36,10,1,1,1,0,0,10,1,2,2,0,20,2,3,3,0,8.00%,0.261,0.283,0.543,66,18.20%,36,11
Frank Vatrano,ANA,W,53,12,13,25,40,-20,17:08,14:08,1:34,1:25,10,2,0,1,1,0,11,2,0,3,1,21,4,0,4,2,16.00%,0.226,0.245,0.472,153,7.80%,67,49
Ryan Johansen,NSH,W,49,11,14,25,32,-14,15:41,12:31,3:07,0:02,7,4,0,1,1,1,9,5,0,3,0,16,9,0,4,1,36.00%,0.224,0.286,0.51,77,14.30%,47,19
Jordan Martinook,CAR,W,51,11,14,25,36,7,15:40,13:34,0:07,1:58,10,0,1,1,0,0,13,0,1,1,0,23,0,2,2,0,0.00%,0.216,0.275,0.49,103,10.70%,55,18
Eetu Luostarinen,FLA,W,54,11,14,25,20,14,15:42,12:25,0:57,2:19,10,1,0,1,0,0,11,2,1,5,0,21,3,1,6,0,12.00%,0.204,0.259,0.463,83,13.30%,42,35
Kevin Labanc,SJS,W,45,10,15,25,22,-3,15:29,13:54,1:34,0:00,8,2,0,0,0,2,14,1,0,1,0,22,3,0,1,0,12.00%,0.222,0.333,0.556,83,12.10%,39,20
Alexander Wennberg,SEA,W,52,10,15,25,10,0,18:44,14:19,2:03,2:20,7,3,0,2,0,0,12,3,0,1,0,19,6,0,3,0,24.00%,0.192,0.288,0.481,66,15.20%,31,44
Brandon Tanev,SEA,W,52,10,15,25,25,22,14:30,11:56,0:04,2:30,10,0,0,3,0,0,15,0,0,2,0,25,0,0,5,0,0.00%,0.192,0.288,0.481,87,11.50%,123,53
Morgan Frost,PHI,W,52,10,15,25,18,-5,15:30,12:56,2:22,0:11,10,0,0,3,0,1,11,4,0,2,0,21,4,0,5,0,16.00%,0.192,0.288,0.481,95,10.50%,59,30
Ryan Strome,ANA,W,53,10,15,25,42,-24,17:02,14:45,2:00,0:16,9,1,0,2,2,0,13,2,0,4,1,22,3,0,6,3,12.00%,0.189,0.283,0.472,86,11.60%,24,18
Stefan Noesen,CAR,W,48,9,16,25,19,9,11:58,9:06,2:51,0:00,3,6,0,3,0,0,10,6,0,0,0,13,12,0,3,0,48.00%,0.188,0.333,0.521,86,10.50%,66,13
Joel Farabee,PHI,W,53,9,16,25,23,0,17:15,14:08,2:12,0:54,9,0,0,1,0,0,15,1,0,2,0,24,1,0,3,0,4.00%,0.17,0.302,0.472,93,9.70%,54,31
Alexis Lafrenière,NYR,W,51,8,17,25,16,8,15:16,13:52,1:21,0:02,8,0,0,2,1,0,16,1,0,2,0,24,1,0,4,1,4.00%,0.157,0.333,0.49,92,8.70%,100,16
Darnell Nurse,EDM,D,52,6,19,25,47,15,23:50,20:04,0:53,2:53,5,0,1,2,0,0,18,1,0,4,2,23,1,1,6,2,4.00%,0.115,0.365,0.481,130,4.60%,87,99
Calen Addison,MIN,D,50,3,22,25,20,-18,16:22,12:35,3:44,0:02,3,0,0,1,0,0,5,17,0,5,2,8,17,0,6,2,68.00%,0.06,0.44,0.5,65,4.60%,14,31
Taylor Raddysh,CHI,W,50,14,10,24,10,-18,16:22,13:13,3:08,0:00,9,5,0,1,0,0,5,5,0,0,0,14,10,0,1,0,41.70%,0.28,0.2,0.48,79,17.70%,57,26
Kent Johnson,CBJ,W,49,10,14,24,10,-6,13:52,12:13,1:38,0:00,8,2,0,1,1,1,10,4,0,2,0,18,6,0,3,1,25.00%,0.204,0.286,0.49,66,15.20%,11,19
Michael Rasmussen,DET,W,48,9,15,24,37,-2,15:11,12:56,0:35,1:38,9,0,0,0,0,0,14,1,0,4,2,23,1,0,4,2,4.20%,0.188,0.313,0.5,79,11.40%,106,40
Anthony Mantha,WSH,W,49,9,15,24,22,-6,14:25,13:34,0:50,0:00,8,1,0,1,0,0,14,1,0,1,0,22,2,0,2,0,8.30%,0.184,0.306,0.49,92,9.80%,51,16
Jared Spurgeon,MIN,D,51,9,15,24,10,16,21:25,17:07,1:12,3:04,8,1,0,2,0,0,12,2,1,0,0,20,3,1,2,0,12.50%,0.176,0.294,0.471,102,8.80%,45,116
Ivan Barbashev,STL,W,51,9,15,24,32,-7,16:17,13:43,1:50,0:43,9,0,0,1,0,0,12,3,0,0,0,21,3,0,1,0,12.50%,0.176,0.294,0.471,76,11.80%,105,24
Mason Marchment,DAL,W,53,9,15,24,68,-1,15:43,14:01,1:40,0:00,7,2,0,1,0,0,12,3,0,5,1,19,5,0,6,1,20.80%,0.17,0.283,0.453,122,7.40%,68,27
Seth Jarvis,CAR,W,51,8,16,24,10,10,15:51,13:32,2:17,0:01,8,0,0,0,0,0,12,4,0,4,2,20,4,0,4,2,16.70%,0.157,0.314,0.471,110,7.30%,50,31
Adam Lowry,WPG,C,52,7,17,24,27,0,15:26,11:46,1:26,2:13,5,0,2,0,0,0,14,2,1,3,2,19,2,3,3,2,8.30%,0.135,0.327,0.462,79,8.90%,122,27
Seth Jones,CHI,D,40,6,18,24,24,-24,24:35:00,19:09,3:20,2:05,5,1,0,1,1,0,9,8,1,3,0,14,9,1,4,1,37.50%,0.15,0.45,0.6,109,5.50%,61,80
Teuvo Teräväinen,CAR,W,41,5,19,24,14,8,16:35,12:07,2:31,1:55,0,3,2,1,0,2,13,5,1,3,0,13,8,3,4,0,33.30%,0.122,0.463,0.585,89,5.60%,11,10
Justin Schultz,SEA,D,44,5,19,24,28,6,18:09,15:49,2:15,0:04,5,0,0,2,1,0,10,9,0,4,1,15,9,0,6,2,37.50%,0.114,0.432,0.545,60,8.30%,18,48
Adam Larsson,SEA,D,52,5,19,24,31,30,24:07:00,21:00,0:09,2:56,4,0,1,0,0,0,19,0,0,0,0,23,0,1,0,0,0.00%,0.096,0.365,0.462,96,5.20%,141,107
Morgan Rielly,TOR,D,38,1,23,24,11,1,22:38,18:04,3:05,1:28,1,0,0,1,0,0,14,9,0,2,1,15,9,0,3,1,37.50%,0.026,0.605,0.632,72,1.40%,41,50
Nino Niederreiter,NSH,W,49,13,10,23,10,-7,15:48,13:40,2:07,0:00,11,2,0,1,0,0,8,2,0,2,1,19,4,0,3,1,17.40%,0.265,0.204,0.469,114,11.40%,103,21
Wyatt Johnston,DAL,W,53,13,10,23,14,4,14:48,13:07,1:33,0:07,11,2,0,2,0,0,7,3,0,3,1,18,5,0,5,1,21.70%,0.245,0.189,0.434,98,13.30%,11,20
Jaden Schwartz,SEA,W,43,10,13,23,14,-11,17:31,14:47,2:23,0:20,5,5,0,1,0,0,13,0,0,1,0,18,5,0,2,0,21.70%,0.233,0.302,0.535,92,10.90%,37,16
Brady Skjei,CAR,D,50,10,13,23,28,17,21:50,18:33,0:47,2:28,6,3,1,2,0,0,11,2,0,3,0,17,5,1,5,0,21.70%,0.2,0.26,0.46,113,8.90%,48,39
Phil Kessel,VGK,W,53,10,13,23,20,-9,12:39,11:08,1:30,0:01,9,1,0,0,0,0,8,5,0,0,0,17,6,0,0,0,26.10%,0.189,0.245,0.434,103,9.70%,8,15
Barclay Goodrow,NYR,W,52,9,14,23,36,5,14:57,12:42,0:20,1:53,8,1,0,2,0,0,12,1,1,3,0,20,2,1,5,0,8.70%,0.173,0.269,0.442,64,14.10%,73,34
Anton Lundell,FLA,W,45,7,16,23,29,3,16:41,12:30,2:10,2:00,5,0,2,0,0,1,11,5,0,2,1,16,5,2,2,1,21.70%,0.156,0.356,0.511,104,6.70%,19,24
Alexander Kerfoot,TOR,C,53,7,16,23,20,8,14:41,12:10,0:42,1:47,4,2,1,1,0,0,14,1,1,3,0,18,3,2,4,0,13.00%,0.132,0.302,0.434,88,8.00%,30,28
Blake Lizotte,LAK,C,53,7,16,23,35,-1,12:35,11:06,0:05,1:24,7,0,0,1,0,0,15,0,1,1,0,22,0,1,2,0,0.00%,0.132,0.302,0.434,63,11.10%,65,26
Shea Theodore,VGK,D,33,4,19,23,6,16,21:52,19:29,2:21,0:02,3,1,0,1,1,0,15,4,0,5,2,18,5,0,6,3,21.70%,0.121,0.576,0.697,83,4.80%,12,45
Noah Hanifin,CGY,D,51,4,19,23,31,12,22:28,18:03,2:05,2:19,3,1,0,0,0,0,16,2,1,4,0,19,3,1,4,0,13.00%,0.078,0.373,0.451,117,3.40%,56,82
Matias Maccelli,ARI,W,34,3,20,23,14,-2,15:00,12:44,2:03,0:12,2,1,0,1,0,0,13,7,0,2,0,15,8,0,3,0,34.80%,0.088,0.588,0.676,25,12.00%,14,7
Nick Bjugstad,ARI,C,52,12,10,22,22,9,16:46,14:08,0:25,2:11,11,0,1,0,0,3,10,0,0,1,0,21,0,1,1,0,0.00%,0.231,0.192,0.423,95,12.60%,108,25
Ross Colton,TBL,W,50,11,11,22,25,-3,12:06,10:43,1:22,0:00,9,2,0,1,0,1,6,5,0,4,0,15,7,0,5,0,31.80%,0.22,0.22,0.44,91,12.10%,119,15
Frederick Gaudreau,MIN,W,51,11,11,22,6,8,15:54,12:25,1:15,2:13,8,1,2,2,0,3,10,0,1,2,1,18,1,3,4,1,4.50%,0.216,0.216,0.431,95,11.60%,29,27
Yegor Sharangovich,NJD,W,51,11,11,22,10,0,14:08,11:57,0:07,2:04,9,0,2,2,1,0,10,0,1,2,0,19,0,3,4,1,0.00%,0.216,0.216,0.431,83,13.30%,17,30
Gustav Nyquist,CBJ,W,48,10,12,22,16,-11,17:48,14:22,1:42,1:43,8,0,2,2,0,1,12,0,0,1,0,20,0,2,3,0,0.00%,0.208,0.25,0.458,97,10.30%,39,28
Nicolas Roy,VGK,W,50,10,12,22,16,5,15:58,13:07,1:37,1:12,8,2,0,2,0,0,9,2,1,1,0,17,4,1,3,0,18.20%,0.2,0.24,0.44,64,15.60%,71,32
Sonny Milano,WSH,W,40,8,14,22,10,-2,13:29,12:23,1:06,0:00,8,0,0,2,0,0,10,4,0,3,1,18,4,0,5,1,18.20%,0.2,0.35,0.55,55,14.60%,32,7
Sam Steel,MIN,C,51,8,14,22,14,9,15:23,13:28,0:54,1:00,8,0,0,2,0,0,11,3,0,4,1,19,3,0,6,1,13.60%,0.157,0.275,0.431,66,12.10%,32,13
Noah Cates,PHI,W,53,8,14,22,4,5,17:39,13:42,2:02,1:54,7,0,1,4,0,0,9,4,1,1,0,16,4,2,5,0,18.20%,0.151,0.264,0.415,64,12.50%,71,42
Neal Pionk,WPG,D,52,7,15,22,25,-5,21:50,18:37,1:45,1:27,6,1,0,1,1,0,14,1,0,3,0,20,2,0,4,1,9.10%,0.135,0.288,0.423,94,7.50%,117,83
Erik Haula,NJD,C,51,4,18,22,37,10,16:43,13:30,1:15,1:57,2,1,1,0,0,0,16,2,0,2,0,18,3,1,2,0,13.60%,0.078,0.353,0.431,97,4.10%,63,39
Oliver Ekman-Larsson,VAN,D,51,2,20,22,20,-19,20:34,17:56,1:37,1:00,2,0,0,0,0,0,15,4,1,1,0,17,4,1,1,0,18.20%,0.039,0.392,0.431,89,2.30%,57,41
Brandon Saad,STL,W,44,14,7,21,6,-9,17:02,14:03,1:49,1:09,11,1,2,1,0,0,7,0,0,0,0,18,1,2,1,0,4.80%,0.318,0.159,0.477,84,16.70%,19,18
Zach Parise,NYI,W,55,14,7,21,12,3,16:25,12:52,1:31,2:01,10,3,1,1,1,0,5,1,1,2,0,15,4,2,3,1,19.00%,0.255,0.127,0.382,120,11.70%,62,61
Ryan Donato,SEA,W,45,12,9,21,23,18,11:43,10:51,0:46,0:04,12,0,0,0,0,0,8,1,0,3,0,20,1,0,3,0,4.80%,0.267,0.2,0.467,76,15.80%,41,7
Anthony Beauvillier,VAN,W,52,10,11,21,10,-5,15:57,14:04,1:30,0:22,9,1,0,3,1,0,11,0,0,1,1,20,1,0,4,2,4.80%,0.192,0.212,0.404,120,8.30%,44,20
Nick Ritchie,ARI,W,49,9,12,21,36,-11,13:51,11:09,2:41,0:00,5,4,0,2,0,1,6,6,0,1,0,11,10,0,3,0,47.60%,0.184,0.245,0.429,75,12.00%,140,25
John Carlson,WSH,D,30,8,13,21,6,-1,23:23,17:09,4:21,1:52,5,2,1,0,0,0,8,5,0,3,0,13,7,1,3,0,33.30%,0.267,0.433,0.7,101,7.90%,34,70
James van Riemsdyk,PHI,W,33,8,13,21,18,2,16:00,13:11,2:48,0:00,6,2,0,1,0,1,11,2,0,2,0,17,4,0,3,0,19.00%,0.242,0.394,0.636,71,11.30%,9,12
Philipp Kurashev,CHI,W,50,7,14,21,8,-27,17:07,14:25,1:47,0:55,7,0,0,1,0,0,10,4,0,0,0,17,4,0,1,0,19.00%,0.14,0.28,0.42,87,8.10%,32,18
Joshua Bailey,NYI,W,51,6,15,21,2,1,15:39,12:51,1:33,1:14,6,0,0,2,0,0,12,3,0,1,0,18,3,0,3,0,14.30%,0.118,0.294,0.412,63,9.50%,10,23
Kristopher Letang,PIT,D,33,5,16,21,16,-10,24:41:00,20:39,3:15,0:46,2,2,1,2,2,0,10,6,0,4,0,12,8,1,6,2,38.10%,0.152,0.485,0.636,72,6.90%,94,60
Torey Krug,STL,D,35,5,16,21,15,-26,19:36,16:52,2:40,0:03,1,4,0,1,0,0,10,6,0,3,2,11,10,0,4,2,47.60%,0.143,0.457,0.6,78,6.40%,29,53
Juuso Pärssinen,NSH,W,35,5,16,21,6,0,15:01,12:52,2:07,0:01,4,1,0,2,0,0,10,6,0,1,0,14,7,0,3,0,33.30%,0.143,0.457,0.6,41,12.20%,62,12
Brett Pesce,CAR,D,51,4,17,21,23,16,22:32,18:16,1:40,2:35,3,1,0,2,1,0,12,3,2,3,1,15,4,2,5,2,19.00%,0.078,0.333,0.412,92,4.40%,21,74
Matthew Benning,SJS,D,51,1,20,21,20,-9,19:25,16:01,0:51,2:32,1,0,0,0,0,0,19,1,0,0,0,20,1,0,0,0,4.80%,0.02,0.392,0.412,38,2.60%,76,84
Nick Jensen,WSH,D,53,1,20,21,14,3,21:00,18:31,0:01,2:26,1,0,0,0,0,0,19,0,1,2,0,20,0,1,2,0,0.00%,0.019,0.377,0.396,68,1.50%,73,94
William Carrier,VGK,W,47,13,7,20,22,11,12:32,12:07,0:13,0:10,13,0,0,6,0,0,7,0,0,2,0,20,0,0,8,0,0.00%,0.277,0.149,0.426,97,13.40%,116,18
Shane Pinto,OTT,W,50,12,8,20,10,-15,15:36,13:19,2:09,0:07,8,4,0,2,0,0,6,2,0,0,0,14,6,0,2,0,30.00%,0.24,0.16,0.4,93,12.90%,45,21
Alex Newhook,COL,W,50,12,8,20,14,1,15:02,13:23,1:35,0:03,11,1,0,2,0,0,8,0,0,0,0,19,1,0,2,0,5.00%,0.24,0.16,0.4,75,16.00%,45,15
Corey Perry,TBL,W,51,10,10,20,54,-14,11:49,9:53,1:56,0:00,4,6,0,3,0,0,4,6,0,2,1,8,12,0,5,1,60.00%,0.196,0.196,0.392,81,12.40%,31,15
Jack Quinn,BUF,W,43,8,12,20,4,3,13:25,11:11,1:48,0:26,7,1,0,1,0,1,7,5,0,0,0,14,6,0,1,0,30.00%,0.186,0.279,0.465,70,11.40%,22,8
Jeff Carter,PIT,C,48,8,12,20,20,-6,14:44,12:06,1:25,1:12,6,2,0,1,1,0,6,5,1,3,0,12,7,1,4,1,35.00%,0.167,0.25,0.417,82,9.80%,55,42
Kyle Okposo,BUF,W,43,7,13,20,18,5,14:49,12:27,1:01,1:20,5,1,1,2,0,0,10,3,0,3,0,15,4,1,5,0,20.00%,0.163,0.302,0.465,88,8.00%,48,14
John Klingberg,ANA,D,45,7,13,20,26,-26,20:58,18:45,2:11,0:02,6,1,0,3,1,0,10,3,0,2,2,16,4,0,5,3,20.00%,0.156,0.289,0.444,68,10.30%,48,58
Nick Foligno,BOS,W,51,7,13,20,41,12,12:21,10:51,1:19,0:09,5,2,0,1,0,0,10,3,0,2,0,15,5,0,3,0,25.00%,0.137,0.255,0.392,62,11.30%,120,26
Christian Dvorak,MTL,W,51,7,13,20,4,-11,16:58,12:31,2:01,2:24,7,0,0,1,0,0,10,3,0,1,0,17,3,0,2,0,15.00%,0.137,0.255,0.392,70,10.00%,9,52
Jesperi Kotkaniemi,CAR,C,51,7,13,20,30,4,14:12,11:59,2:02,0:11,4,2,1,2,0,0,10,3,0,4,0,14,5,1,6,0,25.00%,0.137,0.255,0.392,72,9.70%,69,11
Ty Dellandrea,DAL,W,53,7,13,20,33,11,14:11,11:46,0:02,2:22,7,0,0,2,0,0,11,0,2,1,0,18,0,2,3,0,0.00%,0.132,0.245,0.377,60,11.70%,82,29
Adam Ruzicka,CGY,W,39,6,14,20,8,2,11:48,9:57,1:49,0:00,4,2,0,2,0,0,10,4,0,1,0,14,6,0,3,0,30.00%,0.154,0.359,0.513,57,10.50%,24,4
Jake Sanderson,OTT,D,50,2,18,20,6,-4,21:20,16:02,2:10,3:07,1,1,0,0,0,0,8,10,0,6,0,9,11,0,6,0,55.00%,0.04,0.36,0.4,84,2.40%,27,86
Josh Anderson,MTL,W,49,14,5,19,43,-12,16:23,13:31,1:35,1:16,12,2,0,4,0,0,5,0,0,0,0,17,2,0,4,0,10.50%,0.286,0.102,0.388,111,12.60%,100,31
Andreas Athanasiou,CHI,W,49,11,8,19,26,-14,15:40,14:03,1:32,0:05,10,1,0,2,0,1,7,1,0,2,2,17,2,0,4,2,10.50%,0.224,0.163,0.388,92,12.00%,29,32
Pierre Engvall,TOR,W,51,11,8,19,25,5,13:08,11:36,0:56,0:35,10,1,0,2,0,0,7,1,0,1,0,17,2,0,3,0,10.50%,0.216,0.157,0.373,92,12.00%,39,4
Nic Dowd,WSH,W,44,10,9,19,18,9,12:52,10:38,0:01,2:13,10,0,0,3,0,0,8,0,1,3,1,18,0,1,6,1,0.00%,0.227,0.205,0.432,42,23.80%,97,37
Trent Frederic,BOS,W,48,10,9,19,36,20,11:35,11:02,0:02,0:30,10,0,0,4,0,0,8,0,1,1,0,18,0,1,5,0,0.00%,0.208,0.188,0.396,69,14.50%,58,26
Arthur Kaliyev,LAK,W,34,9,10,19,6,-2,12:18,9:57,2:20,0:00,2,7,0,0,0,0,8,2,0,2,0,10,9,0,2,0,47.40%,0.265,0.294,0.559,79,11.40%,28,8
Sam Lafferty,CHI,C,44,8,11,19,24,-5,14:43,12:21,0:23,1:59,5,0,3,1,0,0,10,0,1,2,1,15,0,4,3,1,0.00%,0.182,0.25,0.432,63,12.70%,77,18
Kasperi Kapanen,PIT,W,37,7,12,19,8,-1,11:52,10:25,0:51,0:35,4,3,0,2,0,0,10,2,0,0,0,14,5,0,2,0,26.30%,0.189,0.324,0.514,60,11.70%,70,9
Trevor Moore,LAK,C,37,7,12,19,8,-4,17:39,13:44,2:16,1:37,5,1,1,1,0,2,7,5,0,3,1,12,6,1,4,1,31.60%,0.189,0.324,0.514,115,6.10%,41,12
Oscar Sundqvist,DET,W,41,7,12,19,20,-5,14:28,11:08,2:20,0:58,5,2,0,0,0,0,7,5,0,2,0,12,7,0,2,0,36.80%,0.171,0.293,0.463,47,14.90%,36,17
John Peterka,BUF,W,48,7,12,19,22,-2,13:50,12:19,1:23,0:07,7,0,0,1,0,0,9,3,0,0,0,16,3,0,1,0,15.80%,0.146,0.25,0.396,75,9.30%,15,7
Barrett Hayton,ARI,C,52,7,12,19,24,-10,16:22,13:01,2:00,1:20,6,1,0,0,0,0,8,4,0,2,0,14,5,0,2,0,26.30%,0.135,0.231,0.365,102,6.90%,63,23
Jesper Fast,CAR,W,49,6,13,19,8,6,14:59,12:52,0:24,1:42,6,0,0,1,0,0,10,0,3,3,0,16,0,3,4,0,0.00%,0.122,0.265,0.388,46,13.00%,63,24
Matt Grzelcyk,BOS,D,47,3,16,19,22,31,17:15,16:35,0:29,0:11,3,0,0,2,0,0,16,0,0,2,0,19,0,0,4,0,0.00%,0.064,0.34,0.404,64,4.70%,27,62
Owen Power,BUF,D,48,3,16,19,18,12,23:08,20:19,1:53,0:55,3,0,0,1,1,0,11,4,1,2,0,14,4,1,3,1,21.10%,0.063,0.333,0.396,76,4.00%,19,57
Mark Giordano,TOR,D,53,3,16,19,45,19,19:31,16:33,0:35,2:23,2,0,1,1,0,0,16,0,0,5,0,18,0,1,6,0,0.00%,0.057,0.302,0.358,78,3.90%,38,102
Ivan Provorov,PHI,D,53,3,16,19,12,-6,23:08,19:12,1:01,2:54,3,0,0,0,0,0,13,2,1,4,1,16,2,1,4,1,10.50%,0.057,0.302,0.358,90,3.30%,64,122
Eric Staal,FLA,W,44,10,8,18,16,-7,13:32,10:46,0:15,2:29,8,0,2,1,0,0,8,0,0,0,0,16,0,2,1,0,0.00%,0.227,0.182,0.409,67,14.90%,19,28
Noel Acciari,STL,C,51,10,8,18,10,-3,14:30,12:38,0:11,1:40,10,0,0,1,0,0,6,0,2,1,0,16,0,2,2,0,0.00%,0.196,0.157,0.353,66,15.20%,158,52
Mike Hoffman,MTL,W,37,9,9,18,18,-4,15:03,12:21,2:39,0:01,8,1,0,3,2,0,5,4,0,1,1,13,5,0,4,3,27.80%,0.243,0.243,0.486,82,11.00%,14,12
Jimmy Vesey,NYR,W,51,9,9,18,4,7,13:56,12:26,0:04,1:26,8,0,1,3,0,0,9,0,0,1,0,17,0,1,4,0,0.00%,0.176,0.176,0.353,89,10.10%,64,31
Valeri Nichushkin,COL,W,22,8,10,18,0,5,20:50,15:42,3:24,1:43,1,6,1,2,0,0,7,2,1,2,1,8,8,2,4,1,44.40%,0.364,0.455,0.818,69,11.60%,26,14
Jonatan Berggren,DET,W,37,8,10,18,12,-2,13:39,11:41,1:58,0:00,5,3,0,0,0,0,6,4,0,2,0,11,7,0,2,0,38.90%,0.216,0.27,0.486,54,14.80%,10,17
Jason Dickinson,CHI,C,46,8,10,18,16,-15,15:16,12:52,0:23,1:59,7,1,0,1,0,0,7,0,3,2,0,14,1,3,3,0,5.60%,0.174,0.217,0.391,61,13.10%,67,53
Christian Fischer,ARI,W,52,8,10,18,18,-5,15:02,12:52,0:08,2:01,7,0,1,0,0,0,9,1,0,1,0,16,1,1,1,0,5.60%,0.154,0.192,0.346,84,9.50%,93,29
Alex Iafallo,LAK,W,30,7,11,18,10,2,16:48,13:33,1:27,1:47,4,3,0,2,0,0,10,1,0,1,0,14,4,0,3,0,22.20%,0.233,0.367,0.6,73,9.60%,18,18
Cody Glass,NSH,W,39,7,11,18,12,7,13:11,11:19,1:42,0:09,5,2,0,0,0,1,10,1,0,3,1,15,3,0,3,1,16.70%,0.179,0.282,0.462,66,10.60%,38,10
Colton Sissons,NSH,W,49,7,11,18,10,8,15:09,11:49,0:27,2:52,7,0,0,0,0,0,11,0,0,1,0,18,0,0,1,0,0.00%,0.143,0.224,0.367,45,15.60%,112,39
Nick Cousins,FLA,W,51,5,13,18,32,-1,11:27,11:13,0:12,0:01,5,0,0,2,0,0,13,0,0,1,0,18,0,0,3,0,0.00%,0.098,0.255,0.353,70,7.10%,51,25
J.J. Moser,ARI,D,52,5,13,18,25,-16,20:27,15:11,2:31,2:44,4,1,0,1,0,0,6,7,0,2,0,10,8,0,3,0,44.40%,0.096,0.25,0.346,58,8.60%,46,82
Nikolaj Ehlers,WPG,W,16,4,14,18,2,1,16:55,13:22,3:33,0:00,3,1,0,0,0,0,9,5,0,1,0,12,6,0,1,0,33.30%,0.25,0.875,1.125,52,7.70%,16,3
Michael Mcleod,NJD,C,51,4,14,18,30,4,12:39,11:14,0:04,1:20,4,0,0,1,0,0,13,0,1,4,0,17,0,1,5,0,0.00%,0.078,0.275,0.353,60,6.70%,84,36
Luke Schenn,VAN,D,51,3,15,18,69,8,17:09,15:16,0:04,1:48,3,0,0,0,0,0,14,0,1,0,0,17,0,1,0,0,0.00%,0.059,0.294,0.353,67,4.50%,244,77
Evan Bouchard,EDM,D,52,3,15,18,16,-4,17:49,15:16,1:43,0:49,3,0,0,0,0,0,10,4,1,0,0,13,4,1,0,0,22.20%,0.058,0.288,0.346,103,2.90%,64,46
Nico Sturm,SJS,W,45,11,6,17,21,-4,14:52,12:08,1:05,1:38,11,0,0,1,0,0,6,0,0,1,0,17,0,0,2,0,0.00%,0.244,0.133,0.378,75,14.70%,67,30
T.J. Oshie,WSH,W,35,10,7,17,27,-7,16:51,13:33,3:14,0:02,5,5,0,1,0,0,6,1,0,3,1,11,6,0,4,1,35.30%,0.286,0.2,0.486,79,12.70%,79,24
Nick Bonino,SJS,W,50,9,8,17,16,-8,15:58,12:23,1:32,2:03,9,0,0,0,0,2,7,1,0,3,0,16,1,0,3,0,5.90%,0.18,0.16,0.34,67,13.40%,13,67
Evander Kane,EDM,W,20,8,9,17,24,1,19:08,16:19,1:57,0:51,7,0,1,0,0,0,7,2,0,1,0,14,2,1,1,0,11.80%,0.4,0.45,0.85,77,10.40%,66,9
Miles Wood,NJD,W,50,8,9,17,49,-2,13:05,11:44,1:18,0:02,8,0,0,0,0,0,9,0,0,2,0,17,0,0,2,0,0.00%,0.16,0.18,0.34,122,6.60%,71,13
Sean Monahan,MTL,W,25,6,11,17,16,-5,17:22,12:33,3:09,1:39,5,1,0,0,0,0,8,3,0,2,1,13,4,0,2,1,23.50%,0.24,0.44,0.68,55,10.90%,10,8
Travis Boyd,ARI,C,52,6,11,17,12,-21,17:02,13:59,2:25,0:37,5,1,0,1,0,0,7,4,0,0,0,12,5,0,1,0,29.40%,0.115,0.212,0.327,60,10.00%,23,35
Fabian Zetterlund,NJD,W,38,5,12,17,6,3,12:59,12:06,0:52,0:01,4,1,0,1,1,0,10,2,0,1,0,14,3,0,2,1,17.60%,0.132,0.316,0.447,69,7.30%,29,10
Mattias Ekholm,NSH,D,49,5,12,17,18,-1,21:36,17:24,1:30,2:41,5,0,0,0,0,0,9,3,0,0,0,14,3,0,0,0,17.60%,0.102,0.245,0.347,84,6.00%,59,62
Logan O'Connor,COL,W,50,5,12,17,27,4,14:57,12:57,0:04,1:55,4,0,1,0,0,0,11,0,1,2,0,15,0,2,2,0,0.00%,0.1,0.24,0.34,67,7.50%,85,33
Samuel Girard,COL,D,44,4,13,17,16,-8,20:40,18:33,1:16,0:51,4,0,0,1,1,0,9,4,0,2,0,13,4,0,3,1,23.50%,0.091,0.295,0.386,72,5.60%,38,61
Jacob Trouba,NYR,D,52,4,13,17,51,-3,21:05,17:47,1:09,2:08,1,2,1,1,0,0,11,1,1,1,0,12,3,2,2,0,17.60%,0.077,0.25,0.327,139,2.90%,159,127
David Kämpf,TOR,C,53,4,13,17,4,3,15:26,12:32,0:04,2:49,4,0,0,1,0,0,11,0,2,3,0,15,0,2,4,0,0.00%,0.075,0.245,0.321,67,6.00%,43,22
Dmitry Orlov,WSH,D,37,3,14,17,6,8,22:44,19:47,1:09,1:47,3,0,0,2,2,0,11,3,0,2,0,14,3,0,4,2,17.60%,0.081,0.378,0.459,70,4.30%,79,56
Ryan Pulock,NYI,D,55,2,15,17,10,11,20:29,17:36,1:05,1:47,2,0,0,1,0,0,11,4,0,2,0,13,4,0,3,0,23.50%,0.036,0.273,0.309,75,2.70%,97,90
Ryan O'Reilly,STL,C,37,10,6,16,6,-28,18:25,14:35,1:59,1:50,8,1,1,2,0,1,5,1,0,0,0,13,2,1,2,0,12.50%,0.27,0.162,0.432,73,13.70%,13,18
Ryan McLeod,EDM,W,39,9,7,16,10,1,14:30,11:56,0:49,1:44,8,0,1,0,0,0,6,0,1,1,0,14,0,2,1,0,0.00%,0.231,0.179,0.41,49,18.40%,29,18
Matthew Nieto,COL,W,49,9,7,16,12,-20,15:23,12:42,0:35,2:05,9,0,0,2,0,0,6,1,0,0,0,15,1,0,2,0,6.30%,0.184,0.143,0.327,80,11.30%,31,20
Kyle Palmieri,NYI,W,28,8,8,16,12,3,16:18,13:55,2:15,0:08,6,2,0,1,0,0,7,1,0,1,0,13,3,0,2,0,18.80%,0.286,0.286,0.571,58,13.80%,47,7
Oliver Wahlstrom,NYI,W,35,7,9,16,32,5,12:09,11:05,1:03,0:00,6,1,0,1,0,0,9,0,0,1,0,15,1,0,2,0,6.30%,0.2,0.257,0.457,70,10.00%,50,15
Lars Eller,WSH,W,51,7,9,16,34,4,15:24,13:29,0:09,1:44,7,0,0,0,0,0,9,0,0,0,0,16,0,0,0,0,0.00%,0.137,0.176,0.314,86,8.10%,73,28
Esa Lindell,DAL,D,53,6,10,16,10,28,19:56,15:53,0:02,3:59,6,0,0,1,0,0,9,0,1,0,0,15,0,1,1,0,0.00%,0.113,0.189,0.302,79,7.60%,60,102
Matt Roy,LAK,D,53,6,10,16,14,-3,18:31,16:28,0:02,1:59,5,0,1,2,0,0,9,0,1,1,1,14,0,2,3,1,0.00%,0.113,0.189,0.302,87,6.90%,86,102
Morgan Geekie,SEA,W,42,5,11,16,18,17,10:26,9:08,0:00,1:17,5,0,0,3,0,0,11,0,0,3,0,16,0,0,6,0,0.00%,0.119,0.262,0.381,43,11.60%,44,18
Ryan Graves,NJD,D,48,5,11,16,16,28,19:19,17:06,0:03,2:09,5,0,0,0,0,0,10,0,1,0,0,15,0,1,0,0,0.00%,0.104,0.229,0.333,82,6.10%,61,92
Paul Stastny,CAR,C,50,5,11,16,14,0,12:34,10:35,1:54,0:04,3,2,0,2,0,0,9,2,0,2,0,12,4,0,4,0,25.00%,0.1,0.22,0.32,55,9.10%,20,12
Damon Severson,NJD,D,50,4,12,16,30,3,20:30,17:37,1:26,1:26,4,0,0,2,1,0,10,2,0,0,0,14,2,0,2,1,12.50%,0.08,0.24,0.32,62,6.50%,25,74
Travis Sanheim,PHI,D,53,4,12,16,34,-7,20:40,18:03,0:41,1:56,3,0,1,0,0,0,11,1,0,0,0,14,1,1,0,0,6.30%,0.075,0.226,0.302,76,5.30%,44,89
Jeff Petry,PIT,D,35,3,13,16,18,2,22:42,18:11,2:32,1:59,1,2,0,0,0,0,9,4,0,1,0,10,6,0,1,0,37.50%,0.086,0.371,0.457,65,4.60%,115,63
Rasmus Sandin,TOR,D,48,3,13,16,23,3,18:02,16:01,1:50,0:10,3,0,0,0,0,0,7,6,0,2,0,10,6,0,2,0,37.50%,0.063,0.271,0.333,50,6.00%,109,54
Dylan Demelo,WPG,D,46,2,14,16,20,9,19:21,16:35,0:04,2:40,1,0,1,0,0,0,12,0,2,2,0,13,0,3,2,0,0.00%,0.043,0.304,0.348,50,4.00%,83,60
Ryan Lindgren,NYR,D,50,1,15,16,39,25,19:09,16:56,0:01,2:11,0,0,1,0,0,0,15,0,0,3,0,15,0,1,3,0,0.00%,0.02,0.3,0.32,59,1.70%,55,82
Eeli Tolvanen,SEA,W,31,10,5,15,12,1,13:57,11:49,1:54,0:14,8,2,0,3,0,0,5,0,0,2,0,13,2,0,5,0,13.30%,0.323,0.161,0.484,63,15.90%,51,31
Brock McGinn,PIT,W,51,10,5,15,17,2,13:14,10:35,0:00,2:38,8,0,2,3,0,0,5,0,0,1,0,13,0,2,4,0,0.00%,0.196,0.098,0.294,72,13.90%,64,30
Trevor Lewis,CGY,W,52,8,7,15,8,-3,12:21,10:17,0:08,1:54,6,1,1,1,0,0,7,0,0,0,0,13,1,1,1,0,6.70%,0.154,0.135,0.288,109,7.30%,100,17
Garnet Hathaway,WSH,W,53,8,7,15,48,7,12:03,10:24,0:00,1:38,8,0,0,0,0,0,7,0,0,2,0,15,0,0,2,0,0.00%,0.151,0.132,0.283,64,12.50%,182,59
Joseph Veleno,DET,W,49,7,8,15,14,0,12:13,11:40,0:22,0:09,7,0,0,1,0,0,6,2,0,2,0,13,2,0,3,0,13.30%,0.143,0.163,0.306,53,13.20%,96,25
Dylan Guenther,ARI,W,33,6,9,15,10,-7,13:06,11:08,1:54,0:03,2,4,0,1,0,0,7,2,0,0,0,9,6,0,1,0,40.00%,0.182,0.273,0.455,53,11.30%,18,11
Jakob Silfverberg,ANA,W,52,6,9,15,12,-15,15:15,10:49,1:38,2:47,4,2,0,0,0,0,8,1,0,1,0,12,3,0,1,0,20.00%,0.115,0.173,0.288,92,6.50%,8,39
Tyler Johnson,CHI,W,24,5,10,15,8,-1,15:17,13:13,2:01,0:02,4,1,0,0,0,0,8,2,0,2,1,12,3,0,2,1,20.00%,0.208,0.417,0.625,43,11.60%,26,11
Ryan Hartman,MIN,C,29,5,10,15,51,-4,14:43,12:55,1:02,0:45,5,0,0,2,0,0,8,1,1,1,0,13,1,1,3,0,6.70%,0.172,0.345,0.517,71,7.00%,30,18
Danton Heinen,PIT,W,42,5,10,15,8,-3,11:03,10:06,0:56,0:00,4,1,0,0,0,0,9,1,0,2,0,13,2,0,2,0,13.30%,0.119,0.238,0.357,57,8.80%,50,17
Nils Lundkvist,DAL,D,46,5,10,15,26,-6,17:10,15:44,1:23,0:02,4,1,0,2,1,0,8,2,0,3,0,12,3,0,5,1,20.00%,0.109,0.217,0.326,77,6.50%,43,50
Nicklaus Perbix,TBL,D,41,4,11,15,14,11,14:51,14:38,0:11,0:01,4,0,0,2,0,0,11,0,0,2,0,15,0,0,4,0,0.00%,0.098,0.268,0.366,68,5.90%,41,36
Marcus Foligno,MIN,W,42,4,11,15,53,-6,15:26,12:53,1:18,1:14,4,0,0,0,0,0,9,2,0,1,0,13,2,0,1,0,13.30%,0.095,0.262,0.357,55,7.30%,152,18
Tyson Jost,BUF,W,44,4,11,15,28,-6,13:44,11:52,0:04,1:47,4,0,0,0,0,0,11,0,0,1,0,15,0,0,1,0,0.00%,0.091,0.25,0.341,63,6.40%,40,16
Olli Määttä,DET,D,46,4,11,15,8,3,17:59,16:41,0:02,1:14,4,0,0,0,0,0,11,0,0,1,0,15,0,0,1,0,0.00%,0.087,0.239,0.326,35,11.40%,46,72
Pierre-Olivier Joseph,PIT,D,47,4,11,15,28,10,14:53,13:45,1:03,0:03,3,1,0,1,0,0,9,2,0,0,0,12,3,0,1,0,20.00%,0.085,0.234,0.319,70,5.70%,62,20
Jaccob Slavin,CAR,D,45,3,12,15,6,10,22:26,19:14,0:10,3:01,3,0,0,1,1,0,11,0,1,1,0,14,0,1,2,1,0.00%,0.067,0.267,0.333,74,4.10%,27,72
Jake McCabe,CHI,D,47,2,13,15,25,3,19:24,17:20,0:04,1:59,2,0,0,1,0,0,13,0,0,2,2,15,0,0,3,2,0.00%,0.043,0.277,0.319,58,3.50%,102,99
Colton Parayko,STL,D,48,2,13,15,22,-21,23:16,20:40,0:44,1:50,2,0,0,1,0,0,10,2,1,2,0,12,2,1,3,0,13.30%,0.042,0.271,0.313,91,2.20%,74,77
Jonas Siegenthaler,NJD,D,51,2,13,15,34,25,20:54,18:01,0:08,2:44,1,1,0,0,0,0,13,0,0,2,0,14,1,0,2,0,6.70%,0.039,0.255,0.294,57,3.50%,65,95
Mackenzie Weegar,CGY,D,51,1,14,15,37,2,20:42,18:18,0:43,1:40,1,0,0,1,0,0,12,1,1,3,0,13,1,1,4,0,6.70%,0.02,0.275,0.294,90,1.10%,107,75
Brenden Dillon,WPG,D,52,1,14,15,57,3,19:45,17:15,0:06,2:23,1,0,0,0,0,0,13,0,1,2,0,14,0,1,2,0,0.00%,0.019,0.269,0.288,61,1.60%,136,78
Alexander Romanov,NYI,D,54,1,14,15,31,4,19:57,17:38,0:02,2:16,1,0,0,0,0,0,13,0,1,2,0,14,0,1,2,0,0.00%,0.019,0.259,0.278,74,1.40%,134,98
Sam Gagner,WPG,W,43,8,6,14,8,-3,12:23,10:47,1:34,0:00,7,1,0,2,0,0,4,2,0,2,0,11,3,0,4,0,21.40%,0.186,0.14,0.326,74,10.80%,14,13
Adam Erne,DET,W,43,6,8,14,8,-7,13:56,12:17,0:01,1:36,6,0,0,1,0,0,7,0,1,1,0,13,0,1,2,0,0.00%,0.14,0.186,0.326,38,15.80%,122,43
Trevor Van Riemsdyk,WSH,D,53,6,8,14,15,8,18:16,15:40,0:09,2:27,6,0,0,0,0,0,7,1,0,0,0,13,1,0,0,0,7.10%,0.113,0.151,0.264,52,11.50%,20,111
Mattias Janmark-Nylén,EDM,W,36,4,10,14,14,2,15:31,13:27,0:04,1:58,4,0,0,0,0,0,9,0,1,1,0,13,0,1,1,0,0.00%,0.111,0.278,0.389,47,8.50%,12,15
Connor Clifton,BOS,D,51,4,10,14,44,17,18:27,16:49,0:07,1:30,4,0,0,0,0,0,10,0,0,3,0,14,0,0,3,0,0.00%,0.078,0.196,0.275,71,5.60%,141,76
Adam Pelech,NYI,D,34,3,11,14,32,12,20:56,18:00,0:07,2:48,3,0,0,0,0,0,10,0,1,3,2,13,0,1,3,2,0.00%,0.088,0.324,0.412,44,6.80%,51,55
Ian Cole,TBL,D,48,3,11,14,49,9,19:11,16:28,0:03,2:39,3,0,0,0,0,0,11,0,0,1,0,14,0,0,1,0,0.00%,0.063,0.229,0.292,70,4.30%,75,81
Kaiden Guhle,MTL,D,36,2,12,14,21,-14,20:46,17:41,0:33,2:30,2,0,0,0,0,0,12,0,0,1,1,14,0,0,1,1,0.00%,0.056,0.333,0.389,36,5.60%,72,65
Juuso Välimäki,ARI,D,48,2,12,14,35,-9,15:23,13:56,1:11,0:14,2,0,0,0,0,0,6,6,0,3,0,8,6,0,3,0,42.90%,0.042,0.25,0.292,51,3.90%,27,38
Marc-Edouard Vlasic,SJS,D,52,1,13,14,6,-10,17:57,15:11,0:04,2:40,1,0,0,0,0,0,13,0,0,1,0,14,0,0,1,0,0.00%,0.019,0.25,0.269,43,2.30%,26,76
Brayden McNabb,VGK,D,53,1,13,14,38,10,20:01,17:48,0:03,2:09,1,0,0,0,0,0,11,0,2,2,0,12,0,2,2,0,0.00%,0.019,0.245,0.264,67,1.50%,126,117
Kirill Marchenko,CBJ,W,29,13,0,13,10,-5,13:37,11:51,1:46,0:00,7,6,0,0,0,1,0,0,0,0,0,7,6,0,0,0,46.20%,0.448,0,0.448,54,24.10%,21,20
Klim Kostin,EDM,W,36,9,4,13,47,7,10:44,10:39,0:05,0:00,9,0,0,2,0,0,4,0,0,0,0,13,0,0,2,0,0.00%,0.25,0.111,0.361,42,21.40%,98,11
Sean Kuraly,CBJ,C,50,9,4,13,48,-22,14:30,11:57,0:08,2:24,8,0,1,0,0,0,3,0,1,1,0,11,0,2,1,0,0.00%,0.18,0.08,0.26,72,12.50%,129,33
Mike Amadio,VGK,W,39,8,5,13,8,-6,11:51,11:27,0:23,0:00,7,1,0,1,0,0,5,0,0,0,0,12,1,0,1,0,7.70%,0.205,0.128,0.333,58,13.80%,38,11
Derick Brassard,OTT,W,40,8,5,13,20,1,13:08,10:50,1:55,0:22,5,3,0,3,0,0,1,4,0,1,0,6,7,0,4,0,53.80%,0.2,0.125,0.325,67,11.90%,56,9
Dakota Joshua,VAN,W,49,8,5,13,52,-13,10:36,9:57,0:10,0:28,7,1,0,1,0,0,5,0,0,0,0,12,1,0,1,0,7.70%,0.163,0.102,0.265,46,17.40%,120,14
Nikita Zadorov,CGY,D,52,8,5,13,51,10,19:19,16:28,0:14,2:36,8,0,0,1,0,0,4,1,0,0,0,12,1,0,1,0,7.70%,0.154,0.096,0.25,81,9.90%,116,54
Ryan Lomberg,FLA,W,54,7,6,13,59,-6,10:17,9:46,0:05,0:25,7,0,0,1,0,0,6,0,0,2,0,13,0,0,3,0,0.00%,0.13,0.111,0.241,75,9.30%,85,12
Peyton Krebs,BUF,W,42,6,7,13,32,-1,12:53,11:47,0:44,0:22,5,0,1,0,0,0,7,0,0,4,1,12,0,1,4,1,0.00%,0.143,0.167,0.31,38,15.80%,48,12
Colin White,FLA,W,43,6,7,13,6,3,10:59,10:16,0:40,0:02,6,0,0,0,0,0,7,0,0,1,0,13,0,0,1,0,0.00%,0.14,0.163,0.302,48,12.50%,34,17
Yakov Trenin,NSH,W,44,6,7,13,33,4,14:08,12:04,0:02,2:00,5,0,1,2,0,0,7,0,0,1,0,12,0,1,3,0,0.00%,0.136,0.159,0.295,82,7.30%,101,17
Luke Kunin,SJS,W,31,5,8,13,42,-9,15:25,12:10,1:24,1:50,3,2,0,0,0,0,6,2,0,0,0,9,4,0,0,0,30.80%,0.161,0.258,0.419,58,8.60%,63,27
Calle Rosén,STL,D,32,5,8,13,6,14,15:01,14:12,0:17,0:31,5,0,0,2,0,0,8,0,0,0,0,13,0,0,2,0,0.00%,0.156,0.25,0.406,38,13.20%,11,35
Pontus Holmberg,TOR,C,34,5,8,13,12,2,10:29,9:49,0:31,0:07,4,1,0,2,0,0,8,0,0,0,0,12,1,0,2,0,7.70%,0.147,0.235,0.382,20,25.00%,22,14
Tanner Jeannot,NSH,W,49,5,8,13,64,2,15:05,11:58,0:38,2:28,5,0,0,1,0,0,8,0,0,3,0,13,0,0,4,0,0.00%,0.102,0.163,0.265,79,6.30%,180,46
Arber Xhekaj,MTL,D,49,5,8,13,92,-7,15:15,14:14,0:44,0:16,3,2,0,0,0,0,7,1,0,0,0,10,3,0,0,0,23.10%,0.102,0.163,0.265,72,6.90%,154,42
Connor Dewar,MIN,C,50,5,8,13,33,-1,10:58,9:07,0:04,1:46,2,0,3,0,0,0,7,0,1,2,0,9,0,4,2,0,0.00%,0.1,0.16,0.26,52,9.60%,78,29
Braden Schneider,NYR,D,52,5,8,13,9,8,15:00,14:19,0:02,0:38,5,0,0,1,0,0,8,0,0,0,0,13,0,0,1,0,0.00%,0.096,0.154,0.25,50,10.00%,79,83
Matthew Martin,NYI,W,54,5,8,13,52,2,10:38,10:34,0:02,0:01,5,0,0,1,0,0,8,0,0,1,0,13,0,0,2,0,0.00%,0.093,0.148,0.241,48,10.40%,211,25
Scott Mayfield,NYI,D,55,5,8,13,56,2,20:53,17:49,0:01,3:02,5,0,0,0,0,0,8,0,0,3,0,13,0,0,3,0,0.00%,0.091,0.145,0.236,88,5.70%,69,115
Yegor Chinakhov,CBJ,W,30,4,9,13,10,-6,13:15,12:03,1:11,0:00,3,1,0,0,0,0,8,1,0,2,2,11,2,0,2,2,15.40%,0.133,0.3,0.433,44,9.10%,27,17
Josh Leivo,STL,W,38,4,9,13,21,0,12:18,11:35,0:42,0:00,4,0,0,0,0,0,9,0,0,1,0,13,0,0,1,0,0.00%,0.105,0.237,0.342,71,5.60%,46,10
Evgeny Dadonov,MTL,W,42,4,9,13,14,-7,14:18,12:19,1:33,0:25,4,0,0,0,0,0,7,2,0,0,0,11,2,0,0,0,15.40%,0.095,0.214,0.31,62,6.50%,16,28
Timothy Liljegren,TOR,D,42,4,9,13,26,20,18:41,16:39,0:21,1:39,3,0,1,0,0,0,7,1,1,1,1,10,1,2,1,1,7.70%,0.095,0.214,0.31,51,7.80%,77,63
Milan Lucic,CGY,W,49,4,9,13,30,-9,11:40,11:25,0:14,0:00,4,0,0,0,0,0,9,0,0,1,0,13,0,0,1,0,0.00%,0.082,0.184,0.265,50,8.00%,106,13
Ben Chiarot,DET,D,50,4,9,13,39,-20,20:48,17:46,0:36,2:25,4,0,0,0,0,0,9,0,0,1,0,13,0,0,1,0,0.00%,0.08,0.18,0.26,81,4.90%,117,113
Sebastian AhoNYI,NYI,D,50,4,9,13,12,4,16:45,15:35,0:32,0:37,4,0,0,0,0,0,8,1,0,0,0,12,1,0,0,0,7.70%,0.08,0.18,0.26,70,5.70%,26,49
Casey Cizikas,NYI,W,54,4,9,13,46,-1,13:56,11:53,0:05,1:57,4,0,0,0,0,0,8,0,1,1,0,12,0,1,1,0,0.00%,0.074,0.167,0.241,64,6.30%,125,37
Anthony Cirelli,TBL,W,28,3,10,13,25,7,16:41,14:07,0:29,2:03,2,1,0,0,0,0,9,1,0,3,1,11,2,0,3,1,15.40%,0.107,0.357,0.464,59,5.10%,13,26
Colin Miller,DAL,D,51,3,10,13,27,20,16:39,16:02,0:11,0:26,3,0,0,1,0,0,10,0,0,3,0,13,0,0,4,0,0.00%,0.059,0.196,0.255,64,4.70%,73,48
William Borgen,SEA,D,52,2,11,13,27,4,15:47,14:13,0:02,1:31,2,0,0,1,0,0,11,0,0,2,0,13,0,0,3,0,0.00%,0.038,0.212,0.25,44,4.60%,137,57
David Savard,MTL,D,38,1,12,13,32,-8,22:15,18:21,0:06,3:46,1,0,0,1,0,0,11,0,1,3,1,12,0,1,4,1,0.00%,0.026,0.316,0.342,36,2.80%,29,114
Nick Leddy,STL,D,47,1,12,13,14,-11,21:10,19:27,0:15,1:27,1,0,0,0,0,0,12,0,0,2,0,13,0,0,2,0,0.00%,0.021,0.255,0.277,52,1.90%,32,57
Ryan Suter,DAL,D,53,1,12,13,22,-6,20:45,17:28,1:37,1:39,1,0,0,0,0,0,7,4,1,5,0,8,4,1,5,0,30.80%,0.019,0.226,0.245,64,1.60%,61,77
Marcus Pettersson,PIT,D,49,0,13,13,32,1,20:50,18:48,0:12,1:49,0,0,0,0,0,0,13,0,0,1,0,13,0,0,1,0,0.00%,0,0.265,0.265,72,0.00%,97,103
Paul Cotter,VGK,W,35,9,3,12,10,-3,13:02,12:31,0:31,0:00,9,0,0,1,0,1,3,0,0,0,0,12,0,0,1,0,0.00%,0.257,0.086,0.343,50,18.00%,114,14
Andrew Cogliano,COL,W,48,8,4,12,28,3,13:35,11:23,0:01,2:10,8,0,0,0,0,0,3,0,1,2,0,11,0,1,2,0,0.00%,0.167,0.083,0.25,63,12.70%,29,34
Warren Foegele,EDM,W,38,7,5,12,14,1,12:30,11:30,0:13,0:46,6,0,1,4,0,0,5,0,0,0,0,11,0,1,4,0,0.00%,0.184,0.132,0.316,70,10.00%,65,16
Derek Ryan,EDM,W,50,7,5,12,24,4,11:02,9:35,0:09,1:17,7,0,0,0,0,0,5,0,0,0,0,12,0,0,0,0,0.00%,0.14,0.1,0.24,58,12.10%,31,30
Radek Faksa,DAL,W,53,7,5,12,29,6,13:29,11:22,0:12,1:55,6,0,1,3,0,0,5,0,0,1,0,11,0,1,4,0,0.00%,0.132,0.094,0.226,53,13.20%,61,51
Ondrej Palat,NJD,W,19,6,6,12,2,5,16:38,14:47,1:35,0:15,6,0,0,1,0,0,4,2,0,2,0,10,2,0,3,0,16.70%,0.316,0.316,0.632,30,20.00%,42,23
Pius Suter,DET,W,47,6,6,12,6,-6,12:49,11:50,0:02,0:57,5,0,1,0,0,0,6,0,0,0,0,11,0,1,0,0,0.00%,0.128,0.128,0.255,59,10.20%,27,21
Morgan Barron,WPG,W,40,5,7,12,12,-1,14:23,12:30,0:06,1:47,4,0,1,1,0,0,6,1,0,1,0,10,1,1,2,0,8.30%,0.125,0.175,0.3,67,7.50%,66,30
Oskar Lindblom,SJS,W,51,5,7,12,6,-12,10:29,9:43,0:32,0:13,5,0,0,0,0,0,6,1,0,0,0,11,1,0,0,0,8.30%,0.098,0.137,0.235,49,10.20%,42,15
Keegan Kolesar,VGK,W,51,5,7,12,48,6,11:34,11:26,0:00,0:07,5,0,0,0,0,0,7,0,0,2,0,12,0,0,2,0,0.00%,0.098,0.137,0.235,41,12.20%,183,24
Kailer Yamamoto,EDM,W,31,4,8,12,10,7,16:41,14:14,0:44,1:42,3,0,1,1,0,0,8,0,0,3,0,11,0,1,4,0,0.00%,0.129,0.258,0.387,40,10.00%,43,12
Eric Robinson,CBJ,W,45,4,8,12,6,-13,13:43,11:21,0:00,2:22,4,0,0,1,0,0,6,0,2,0,0,10,0,2,1,0,0.00%,0.089,0.178,0.267,64,6.30%,72,18
Mathew Dumba,MIN,D,49,4,8,12,54,-3,21:20,19:17,0:05,1:57,4,0,0,2,0,0,8,0,0,0,0,12,0,0,2,0,0.00%,0.082,0.163,0.245,64,6.30%,66,73
Mathieu Joseph,OTT,W,31,3,9,12,26,6,14:19,11:22,0:35,2:21,0,1,2,0,0,0,8,1,0,3,0,8,2,2,3,0,16.70%,0.097,0.29,0.387,34,8.80%,49,18
Brett Kulak,EDM,D,52,2,10,12,29,5,18:08,16:00,0:05,2:02,2,0,0,0,0,0,9,0,1,1,0,11,0,1,1,0,0.00%,0.038,0.192,0.231,67,3.00%,65,78
Michael Anderson,LAK,D,53,2,10,12,18,9,21:50,19:18,0:06,2:24,2,0,0,0,0,0,9,0,1,1,0,11,0,1,1,0,0.00%,0.038,0.189,0.226,59,3.40%,119,83
Conor Timmins,TOR,D,20,1,11,12,2,-2,15:41,14:18,1:16,0:06,1,0,0,1,0,0,8,3,0,3,1,9,3,0,4,1,25.00%,0.05,0.55,0.6,16,6.30%,17,12
Jaycob Megna,SEA,D,49,1,11,12,21,4,19:02,17:15,0:03,1:44,1,0,0,0,0,0,10,0,1,1,0,11,0,1,1,0,0.00%,0.02,0.224,0.245,49,2.00%,77,63
Jonathan Drouin,MTL,W,28,0,12,12,2,-14,13:46,11:11,2:35,0:00,0,0,0,0,0,0,6,6,0,2,0,6,6,0,2,0,50.00%,0,0.429,0.429,34,0.00%,22,9
Kevin Shattenkirk,ANA,D,46,0,12,12,44,-10,18:12,14:51,1:44,1:35,0,0,0,0,0,0,9,3,0,0,0,9,3,0,0,0,25.00%,0,0.261,0.261,97,0.00%,55,69
Brian Dumoulin,PIT,D,51,0,12,12,12,2,20:28,17:26,0:02,2:59,0,0,0,0,0,0,10,0,2,3,0,10,0,2,3,0,0.00%,0,0.235,0.235,36,0.00%,77,91
Wade Allison,PHI,W,34,7,4,11,13,10,12:16,11:50,0:25,0:00,7,0,0,1,0,0,4,0,0,0,0,11,0,0,1,0,0.00%,0.206,0.118,0.324,53,13.20%,100,34
Jack McBain,ARI,C,52,7,4,11,40,-9,13:23,11:22,0:02,1:58,7,0,0,2,0,0,4,0,0,0,0,11,0,0,2,0,0.00%,0.135,0.077,0.212,59,11.90%,176,35
Ryan Poehling,PIT,W,37,5,6,11,2,7,10:58,8:43,0:05,2:09,3,0,2,0,0,0,5,0,1,0,0,8,0,3,0,0,0.00%,0.135,0.162,0.297,45,11.10%,49,26
Nate Schmidt,WPG,D,43,5,6,11,8,10,19:20,16:27,1:35,1:17,2,3,0,0,0,0,5,1,0,1,0,7,4,0,1,0,36.40%,0.116,0.14,0.256,58,8.60%,27,52
Jamie Oleksiak,SEA,D,45,5,6,11,46,2,19:07,16:10,0:01,2:54,5,0,0,0,0,0,6,0,0,2,0,11,0,0,2,0,0.00%,0.111,0.133,0.244,39,12.80%,92,77
Zemgus Girgensons,BUF,W,48,5,6,11,8,-2,12:35,11:10,0:01,1:23,5,0,0,0,0,0,6,0,0,1,0,11,0,0,1,0,0.00%,0.104,0.125,0.229,57,8.80%,54,28
Jalen Chatfield,CAR,D,51,5,6,11,31,15,14:06,13:03,0:00,1:02,4,0,1,2,0,0,5,0,1,1,0,9,0,2,3,0,0.00%,0.098,0.118,0.216,54,9.30%,54,45
Thomas Novak,NSH,W,20,4,7,11,4,0,11:20,9:26,1:53,0:00,3,1,0,1,0,0,5,2,0,1,0,8,3,0,2,0,27.30%,0.2,0.35,0.55,39,10.30%,3,6
Emil Bemström,CBJ,W,25,4,7,11,2,-5,12:16,10:52,1:24,0:00,3,1,0,0,0,0,5,2,0,0,0,8,3,0,0,0,27.30%,0.16,0.28,0.44,39,10.30%,10,6
Mason Shaw,MIN,W,34,4,7,11,58,1,11:32,9:50,0:15,1:26,4,0,0,0,0,0,5,0,2,1,0,9,0,2,1,0,0.00%,0.118,0.206,0.324,58,6.90%,57,13
Axel Jonsson Fjällby,WPG,W,45,4,7,11,8,-3,10:26,9:31,0:02,0:53,4,0,0,2,0,0,6,0,1,0,0,10,0,1,2,0,0.00%,0.089,0.156,0.244,51,7.80%,38,18
Vladislav Namestnikov,TBL,W,49,4,7,11,17,-4,11:53,10:04,1:01,0:47,4,0,0,0,0,0,5,2,0,1,0,9,2,0,1,0,18.20%,0.082,0.143,0.224,61,6.60%,60,18
Joshua Mahura,FLA,D,54,4,7,11,20,13,14:23,13:47,0:10,0:24,4,0,0,1,0,0,7,0,0,0,0,11,0,0,1,0,0.00%,0.074,0.13,0.204,59,6.80%,59,46
Marcus Björk,CBJ,D,27,3,8,11,24,-7,18:47,15:59,2:29,0:17,2,1,0,0,0,0,3,5,0,0,0,5,6,0,0,0,54.50%,0.111,0.296,0.407,29,10.30%,36,42
Michael Eyssimont,SJS,W,31,3,8,11,31,8,11:46,11:02,0:44,0:00,3,0,0,0,0,0,8,0,0,0,0,11,0,0,0,0,0.00%,0.097,0.258,0.355,59,5.10%,61,11
Ethan Bear,VAN,D,39,3,8,11,10,3,18:25,16:34,0:04,1:46,3,0,0,1,0,0,8,0,0,0,0,11,0,0,1,0,0.00%,0.077,0.205,0.282,54,5.60%,30,51
Caleb Jones,CHI,D,41,2,9,11,26,-12,18:00,15:58,1:34,0:27,2,0,0,1,1,0,6,3,0,1,0,8,3,0,2,1,27.30%,0.049,0.22,0.268,49,4.10%,63,53
Jake Evans,MTL,W,43,2,9,11,20,-8,14:21,11:22,0:04,2:54,1,1,0,0,0,0,9,0,0,0,0,10,1,0,0,0,9.10%,0.047,0.209,0.256,42,4.80%,22,30
Cole Smith,NSH,W,43,2,9,11,43,0,11:46,9:48,0:03,1:54,2,0,0,0,0,0,8,0,1,2,0,10,0,1,2,0,0.00%,0.047,0.209,0.256,47,4.30%,118,16
Nicolas Hague,VGK,D,52,2,9,11,18,-4,18:19,17:24,0:04,0:50,2,0,0,1,1,0,9,0,0,1,0,11,0,0,2,1,0.00%,0.038,0.173,0.212,69,2.90%,73,94
Justin Holl,TOR,D,53,2,9,11,24,12,21:05,17:51,0:04,3:09,2,0,0,1,0,0,9,0,0,2,0,11,0,0,3,0,0.00%,0.038,0.17,0.208,40,5.00%,100,90
Cam York,PHI,D,26,1,10,11,6,10,19:35,17:26,1:51,0:18,1,0,0,0,0,0,8,1,1,1,0,9,1,1,1,0,9.10%,0.038,0.385,0.423,20,5.00%,21,38
Ryan McDonagh,NSH,D,42,1,10,11,12,13,20:58,17:47,0:06,3:04,1,0,0,1,0,0,10,0,0,2,0,11,0,0,3,0,0.00%,0.024,0.238,0.262,44,2.30%,30,87
Jordan Harris,MTL,D,47,1,10,11,18,-6,18:25,17:06,0:03,1:15,1,0,0,0,0,0,9,1,0,0,0,10,1,0,0,0,9.10%,0.021,0.213,0.234,48,2.10%,40,66
Sheldon Dries,VAN,W,33,6,4,10,15,-8,11:27,9:48,1:34,0:04,4,2,0,0,0,0,3,1,0,1,0,7,3,0,1,0,30.00%,0.182,0.121,0.303,47,12.80%,38,16
Carl Grundström,LAK,W,37,6,4,10,14,-7,11:04,10:12,0:07,0:44,5,1,0,1,0,0,4,0,0,0,0,9,1,0,1,0,10.00%,0.162,0.108,0.27,53,11.30%,93,9
Jaret Anderson-Dolan,LAK,W,38,6,4,10,2,-6,10:58,10:23,0:26,0:08,6,0,0,1,0,0,3,1,0,0,0,9,1,0,1,0,10.00%,0.158,0.105,0.263,51,11.80%,51,24
Michael Stone,CGY,D,42,5,5,10,31,3,13:07,12:16,0:29,0:21,5,0,0,0,0,0,3,2,0,0,0,8,2,0,0,0,20.00%,0.119,0.119,0.238,78,6.40%,46,46
Steven Lorentz,SJS,W,51,5,5,10,14,-11,11:24,10:25,0:10,0:49,5,0,0,0,0,0,5,0,0,0,0,10,0,0,0,0,0.00%,0.098,0.098,0.196,68,7.40%,83,25
Jani Hakanpää,DAL,D,53,5,5,10,42,20,19:23,15:36,0:03,3:42,5,0,0,1,0,0,5,0,0,2,0,10,0,0,3,0,0.00%,0.094,0.094,0.189,50,10.00%,149,85
John Marino,NJD,D,34,4,6,10,10,11,21:20,17:40,0:22,3:18,4,0,0,0,0,0,6,0,0,1,0,10,0,0,1,0,0.00%,0.118,0.176,0.294,45,8.90%,33,44
Juraj Slafkovsky,MTL,W,39,4,6,10,33,-13,12:12,10:54,1:17,0:00,3,1,0,0,0,0,5,1,0,1,0,8,2,0,1,0,20.00%,0.103,0.154,0.256,42,9.50%,53,24
Martin Fehervary,WSH,D,41,4,6,10,18,-1,19:26,18:03,0:02,1:20,4,0,0,1,0,0,6,0,0,0,0,10,0,0,1,0,0.00%,0.098,0.146,0.244,56,7.10%,135,69
Jesse Puljujärvi,EDM,W,49,4,6,10,26,-13,12:34,11:49,0:45,0:00,4,0,0,0,0,0,6,0,0,0,0,10,0,0,0,0,0.00%,0.082,0.122,0.204,72,5.60%,99,18
Alexei Protas,WSH,W,42,3,7,10,4,1,10:54,10:41,0:06,0:06,3,0,0,0,0,0,7,0,0,2,0,10,0,0,2,0,0.00%,0.071,0.167,0.238,54,5.60%,32,8
Nick Seeler,PHI,D,50,3,7,10,30,5,14:19,13:21,0:01,0:56,3,0,0,0,0,0,6,0,1,1,0,9,0,1,1,0,0.00%,0.06,0.14,0.2,57,5.30%,82,86
Vladislav Gavrikov,CBJ,D,51,3,7,10,30,-8,22:20,18:19,0:27,3:33,3,0,0,2,2,0,6,0,1,1,1,9,0,1,3,3,0.00%,0.059,0.137,0.196,61,4.90%,54,88
Jon Merrill,MIN,D,47,2,8,10,18,-5,15:17,14:04,0:05,1:07,2,0,0,0,0,0,8,0,0,3,0,10,0,0,3,0,0.00%,0.043,0.17,0.213,34,5.90%,32,59
Dmitri Kulikov,ANA,D,53,2,8,10,28,-15,20:16,17:08,0:02,3:05,2,0,0,0,0,0,8,0,0,1,0,10,0,0,1,0,0.00%,0.038,0.151,0.189,70,2.90%,81,91
Erik Cernak,TBL,D,47,1,9,10,42,2,19:26,16:27,0:05,2:53,1,0,0,0,0,0,9,0,0,1,0,10,0,0,1,0,0.00%,0.021,0.191,0.213,49,2.00%,151,77
Tyler Myers,VAN,D,49,1,9,10,55,-7,20:49,18:48,0:05,1:55,1,0,0,0,0,0,9,0,0,3,0,10,0,0,3,0,0.00%,0.02,0.184,0.204,69,1.50%,55,71
Erik Gudbranson,CBJ,D,51,1,9,10,40,-20,20:51,18:40,0:03,2:07,1,0,0,1,0,0,9,0,0,1,1,10,0,0,2,1,0.00%,0.02,0.176,0.196,72,1.40%,92,97
Adam Boqvist,CBJ,D,20,0,10,10,2,-4,17:07,14:42,2:24,0:00,0,0,0,0,0,0,7,3,0,1,0,7,3,0,1,0,30.00%,0,0.5,0.5,26,0.00%,12,17
Julien Gauthier,NYR,W,36,6,3,9,4,-3,8:20,8:19,0:00,0:00,6,0,0,0,0,0,3,0,0,1,0,9,0,0,1,0,0.00%,0.167,0.083,0.25,34,17.70%,67,6
Jake Walman,DET,D,34,5,4,9,24,14,18:55,16:44,0:38,1:32,5,0,0,1,1,0,3,1,0,1,0,8,1,0,2,1,11.10%,0.147,0.118,0.265,78,6.40%,30,63
A.J. Greer,BOS,W,36,5,4,9,64,4,9:08,9:02,0:06,0:00,5,0,0,1,0,0,4,0,0,1,0,9,0,0,2,0,0.00%,0.139,0.111,0.25,34,14.70%,74,15
Maxime Comtois,ANA,W,42,5,4,9,70,-13,13:52,12:55,0:47,0:09,5,0,0,0,0,0,4,0,0,0,0,9,0,0,0,0,0.00%,0.119,0.095,0.214,62,8.10%,61,18
Brendan Gallagher,MTL,W,25,4,5,9,31,-6,14:11,12:11,2:00,0:00,4,0,0,1,0,0,3,2,0,0,0,7,2,0,1,0,22.20%,0.16,0.2,0.36,57,7.00%,11,8
Evgeny Svechnikov,SJS,W,37,4,5,9,18,0,10:47,10:28,0:19,0:00,4,0,0,0,0,0,5,0,0,0,0,9,0,0,0,0,0.00%,0.108,0.135,0.243,42,9.50%,58,14
Derek Forbort,BOS,D,40,4,5,9,14,12,18:09,14:54,0:01,3:13,2,0,2,2,0,0,5,0,0,0,0,7,0,2,2,0,0.00%,0.1,0.125,0.225,29,13.80%,90,67
Zack MacEwen,PHI,W,46,4,5,9,54,-9,12:18,11:37,0:39,0:01,4,0,0,3,0,0,5,0,0,0,0,9,0,0,3,0,0.00%,0.087,0.109,0.196,63,6.40%,130,23
Nils Höglander,VAN,W,25,3,6,9,6,-4,12:03,11:48,0:14,0:00,3,0,0,0,0,0,6,0,0,0,0,9,0,0,0,0,0.00%,0.12,0.24,0.36,29,10.30%,21,8
Nathan Bastian,NJD,W,28,3,6,9,24,4,13:02,10:08,1:25,1:29,3,0,0,1,0,0,6,0,0,0,0,9,0,0,1,0,0.00%,0.107,0.214,0.321,35,8.60%,60,26
Tyler Motte,OTT,W,34,3,6,9,4,3,13:43,10:31,0:21,2:50,2,0,1,0,0,0,6,0,0,2,0,8,0,1,2,0,0.00%,0.088,0.176,0.265,63,4.80%,73,33
Craig Smith,BOS,W,37,3,6,9,12,2,10:14,9:57,0:16,0:00,3,0,0,0,0,0,5,1,0,2,0,8,1,0,2,0,11.10%,0.081,0.162,0.243,44,6.80%,30,7
Dylan Holloway,EDM,W,48,3,6,9,27,0,9:30,8:52,0:37,0:00,3,0,0,1,0,0,6,0,0,0,0,9,0,0,1,0,0.00%,0.063,0.125,0.188,41,7.30%,75,15
Quinton Byfield,LAK,W,24,2,7,9,16,-1,13:20,11:52,1:17,0:10,1,1,0,0,0,0,7,0,0,0,0,8,1,0,0,0,11.10%,0.083,0.292,0.375,28,7.10%,18,10
T.J. Brodie,TOR,D,31,2,7,9,4,10,21:10,18:10,0:04,2:55,2,0,0,0,0,0,6,0,1,0,0,8,0,1,0,0,0.00%,0.065,0.226,0.29,39,5.10%,25,54
Calvin de Haan,CAR,D,42,2,7,9,18,3,13:20,12:43,0:00,0:36,2,0,0,0,0,0,7,0,0,0,0,9,0,0,0,0,0.00%,0.048,0.167,0.214,39,5.10%,66,42
Radko Gudas,FLA,D,44,2,7,9,55,4,18:07,15:28,0:05,2:32,2,0,0,0,0,0,7,0,0,0,0,9,0,0,0,0,0.00%,0.045,0.159,0.205,71,2.80%,177,76
Colin Blackwell,CHI,W,44,2,7,9,6,-11,11:50,10:14,0:03,1:32,2,0,0,0,0,0,6,0,1,1,0,8,0,1,1,0,0.00%,0.045,0.159,0.205,45,4.40%,44,15
Rasmus Ristolainen,PHI,D,46,2,7,9,26,0,18:09,15:59,0:06,2:03,1,0,1,0,0,0,6,0,1,2,0,7,0,2,2,0,0.00%,0.043,0.152,0.196,46,4.40%,100,99
Sean Walker,LAK,D,46,2,7,9,28,-7,15:04,13:58,0:08,0:58,2,0,0,0,0,0,7,0,0,0,0,9,0,0,0,0,0.00%,0.043,0.152,0.196,65,3.10%,52,65
Brandon Carlo,BOS,D,47,2,7,9,25,20,18:29,15:19,0:00,3:08,2,0,0,0,0,0,6,0,1,2,0,8,0,1,2,0,0.00%,0.043,0.149,0.191,60,3.30%,88,76
Patrick Maroon,TBL,W,51,2,7,9,70,-2,10:23,10:19,0:04,0:00,2,0,0,0,0,0,6,1,0,0,0,8,1,0,0,0,11.10%,0.039,0.137,0.176,46,4.40%,107,5
Carson Soucy,SEA,D,52,2,7,9,41,11,16:16,14:20,0:12,1:43,2,0,0,0,0,0,7,0,0,0,0,9,0,0,0,0,0.00%,0.038,0.135,0.173,53,3.80%,97,57
Isac Lundeström,ANA,W,32,1,8,9,2,-2,14:22,12:05,0:12,2:03,0,0,1,0,0,0,8,0,0,1,1,8,0,1,1,1,0.00%,0.031,0.25,0.281,35,2.90%,11,16
Nick Holden,OTT,D,45,1,8,9,10,-5,16:22,13:40,0:01,2:40,1,0,0,0,0,0,7,0,1,0,0,8,0,1,0,0,0.00%,0.022,0.178,0.2,51,2.00%,60,47
Brett Ritchie,CGY,W,30,6,2,8,21,2,9:12,9:01,0:10,0:00,6,0,0,0,0,0,2,0,0,0,0,8,0,0,0,0,0.00%,0.2,0.067,0.267,41,14.60%,52,4
Elmer Söderblom,DET,W,21,5,3,8,8,0,12:04,10:56,1:07,0:00,5,0,0,2,0,0,3,0,0,0,0,8,0,0,2,0,0.00%,0.238,0.143,0.381,30,16.70%,21,11
Jesper Boqvist,NJD,C,41,5,3,8,0,-1,10:52,10:20,0:03,0:29,5,0,0,2,0,0,3,0,0,1,0,8,0,0,3,0,0.00%,0.122,0.073,0.195,37,13.50%,22,12
Derek Stepan,CAR,W,45,5,3,8,8,6,8:54,7:55,0:03,0:55,5,0,0,0,0,0,3,0,0,0,0,8,0,0,0,0,0.00%,0.111,0.067,0.178,71,7.00%,12,9
Connor Murphy,CHI,D,50,5,3,8,42,-2,19:27,17:15,0:02,2:08,4,0,1,0,0,0,3,0,0,0,0,7,0,1,0,0,0.00%,0.1,0.06,0.16,57,8.80%,102,106
Andrew Peeke,CBJ,D,50,5,3,8,20,-17,20:34,17:21,0:01,3:11,5,0,0,1,0,0,2,0,1,0,0,7,0,1,1,0,0.00%,0.1,0.06,0.16,52,9.60%,106,103
Jake Neighbours,STL,W,27,4,4,8,9,-16,12:22,11:18,1:01,0:02,3,1,0,0,0,0,3,1,0,1,0,6,2,0,1,0,25.00%,0.148,0.148,0.296,34,11.80%,31,10
Cal Clutterbuck,NYI,W,34,4,4,8,18,4,12:09,10:09,0:02,1:57,4,0,0,0,0,0,4,0,0,0,0,8,0,0,0,0,0.00%,0.118,0.118,0.235,27,14.80%,130,25
Saku Mäenalanen,WPG,W,36,4,4,8,10,3,11:20,10:10,0:04,1:06,4,0,0,0,0,0,4,0,0,3,0,8,0,0,3,0,0.00%,0.111,0.111,0.222,41,9.80%,69,17
Zachary Werenski,CBJ,D,13,3,5,8,0,-6,23:35,19:33,3:04,0:58,3,0,0,0,0,0,3,2,0,0,0,6,2,0,0,0,25.00%,0.231,0.385,0.615,41,7.30%,5,24
Lukas Sedlak,PHI,W,30,3,5,8,12,4,12:12,10:13,0:21,1:37,3,0,0,0,0,0,4,0,1,1,0,7,0,1,1,0,0.00%,0.1,0.167,0.267,44,6.80%,58,31
Tomas Nosek,BOS,W,42,3,5,8,34,4,12:28,9:47,0:02,2:39,2,0,1,0,0,0,5,0,0,1,0,7,0,1,1,0,0.00%,0.071,0.119,0.19,43,7.00%,45,21
Jan Rutta,PIT,D,42,3,5,8,22,4,17:50,15:06,0:01,2:42,3,0,0,0,0,0,5,0,0,0,0,8,0,0,0,0,0.00%,0.071,0.119,0.19,53,5.70%,58,52
Mario Ferraro,SJS,D,43,3,5,8,12,-23,21:47,18:16,0:56,2:35,3,0,0,0,0,0,4,1,0,0,0,7,1,0,0,0,12.50%,0.07,0.116,0.186,41,7.30%,68,83
Mathieu Olivier,CBJ,W,47,3,5,8,72,-19,11:20,10:39,0:00,0:40,3,0,0,1,0,0,5,0,0,0,0,8,0,0,1,0,0.00%,0.064,0.106,0.17,51,5.90%,122,39
Pierre-Edouard Bellemare,TBL,W,49,3,5,8,30,-4,11:21,9:00,0:01,2:19,3,0,0,0,0,0,4,0,1,0,0,7,0,1,0,0,0.00%,0.061,0.102,0.163,34,8.80%,52,37
Travis Hamonic,OTT,D,50,3,5,8,57,-12,18:52,15:43,0:05,3:03,3,0,0,0,0,0,4,0,1,0,0,7,0,1,0,0,0.00%,0.06,0.1,0.16,83,3.60%,68,89
Nick Deslauriers,PHI,W,53,3,5,8,89,-8,10:12,9:12,0:02,0:57,3,0,0,0,0,0,5,0,0,1,0,8,0,0,1,0,0.00%,0.057,0.094,0.151,49,6.10%,208,18
Rasmus Asplund,BUF,W,26,2,6,8,0,1,11:25,10:13,0:01,1:11,1,0,1,0,0,0,6,0,0,0,0,7,0,1,0,0,0.00%,0.077,0.231,0.308,30,6.70%,9,8
Denis Guryanov,DAL,W,37,2,6,8,4,-2,12:26,11:15,1:10,0:00,2,0,0,0,0,0,5,1,0,2,0,7,1,0,2,0,12.50%,0.054,0.162,0.216,60,3.30%,20,16
Dylan Samberg,WPG,D,39,2,6,8,12,7,15:23,13:28,0:04,1:50,2,0,0,0,0,0,5,0,1,1,0,7,0,1,1,0,0.00%,0.051,0.154,0.205,32,6.30%,61,68
Alexandre Carrier,NSH,D,40,2,6,8,25,-3,18:04,15:26,0:32,2:05,2,0,0,1,1,0,6,0,0,1,0,8,0,0,2,1,0.00%,0.05,0.15,0.2,46,4.40%,54,62
Jonas Brodin,MIN,D,43,2,6,8,20,7,22:32,19:12,0:20,2:59,2,0,0,0,0,0,5,0,1,0,0,7,0,1,0,0,0.00%,0.047,0.14,0.186,63,3.20%,35,95
Jacob Middleton,MIN,D,50,2,6,8,61,3,18:22,16:10,0:06,2:05,2,0,0,0,0,0,5,0,1,0,0,7,0,1,0,0,0.00%,0.04,0.12,0.16,45,4.40%,74,93
Michael Matheson,MTL,D,17,1,7,8,21,-1,23:12,17:31,3:51,1:49,1,0,0,0,0,0,4,3,0,0,0,5,3,0,0,0,37.50%,0.059,0.412,0.471,39,2.60%,24,18
Teodors Blueger,PIT,C,36,1,7,8,16,-4,12:41,9:59,0:05,2:37,1,0,0,0,0,0,6,0,1,0,0,7,0,1,0,0,0.00%,0.028,0.194,0.222,47,2.10%,44,32
Christopher Tanev,CGY,D,42,1,7,8,13,-1,19:51,16:37,0:15,2:58,1,0,0,1,0,0,6,1,0,1,0,7,1,0,2,0,12.50%,0.024,0.167,0.19,41,2.40%,27,87
Jacob Bryson,BUF,D,42,1,7,8,6,-17,15:13,13:54,0:05,1:13,1,0,0,0,0,0,6,0,1,1,0,7,0,1,1,0,0.00%,0.024,0.167,0.19,22,4.60%,20,50
Dante Fabbro,NSH,D,46,1,7,8,26,2,16:09,14:43,0:03,1:22,1,0,0,0,0,0,7,0,0,0,0,8,0,0,0,0,0.00%,0.022,0.152,0.174,63,1.60%,55,67
Alec Martinez,VGK,D,49,1,7,8,16,13,19:03,17:14,0:10,1:37,1,0,0,0,0,0,7,0,0,1,0,8,0,0,1,0,0.00%,0.02,0.143,0.163,48,2.10%,31,156
Vince Hinostroza,BUF,W,19,0,8,8,6,-2,12:14,11:49,0:02,0:22,0,0,0,0,0,0,7,0,1,1,0,7,0,1,1,0,0.00%,0,0.421,0.421,23,0.00%,1,5
Ilya Lyubushkin,BUF,D,36,0,8,8,32,0,14:20,12:15,0:00,2:04,0,0,0,0,0,0,7,0,1,2,0,7,0,1,2,0,0.00%,0,0.222,0.222,18,0.00%,62,46
Zach Aston-Reese,TOR,W,50,5,2,7,21,-5,11:02,9:58,0:02,1:01,5,0,0,1,0,0,2,0,0,0,0,7,0,0,1,0,0.00%,0.1,0.04,0.14,50,10.00%,106,32
Mark Jankowski,NSH,W,24,4,3,7,10,5,12:07,10:15,0:05,1:46,3,0,1,2,0,0,3,0,0,0,0,6,0,1,2,0,0.00%,0.167,0.125,0.292,25,16.00%,25,20
Josh Archibald,PIT,W,32,4,3,7,18,9,10:13,8:34,0:04,1:33,4,0,0,0,0,0,3,0,0,0,0,7,0,0,0,0,0.00%,0.125,0.094,0.219,44,9.10%,116,11
Max Jones,ANA,W,40,4,3,7,37,-14,12:04,11:46,0:08,0:09,4,0,0,0,0,0,3,0,0,0,0,7,0,0,0,0,0.00%,0.1,0.075,0.175,59,6.80%,68,9
Brett Leason,ANA,W,42,4,3,7,6,-16,11:13,11:04,0:04,0:03,4,0,0,0,0,0,3,0,0,0,0,7,0,0,0,0,0.00%,0.095,0.071,0.167,37,10.80%,29,15
Nick Blankenburg,CBJ,D,16,3,4,7,8,-6,18:18,16:08,0:58,1:11,3,0,0,1,0,0,3,1,0,0,0,6,1,0,1,0,14.30%,0.188,0.25,0.438,24,12.50%,28,28
Joel Armia,MTL,W,32,3,4,7,16,-7,15:02,12:13,0:43,2:05,3,0,0,0,0,0,4,0,0,1,0,7,0,0,1,0,0.00%,0.094,0.125,0.219,56,5.40%,28,21
Karson Kuhlman,WPG,W,36,3,4,7,8,-3,12:01,10:48,0:03,1:08,3,0,0,2,0,0,4,0,0,0,0,7,0,0,2,0,0.00%,0.083,0.111,0.194,41,7.30%,33,13
Rasmus Kupari,LAK,C,37,3,4,7,8,-5,9:52,9:03,0:01,0:46,3,0,0,0,0,0,3,0,1,2,0,6,0,1,2,0,0.00%,0.081,0.108,0.189,26,11.50%,48,22
Alexei Toropchenko,STL,W,38,3,4,7,10,-3,10:45,10:00,0:04,0:40,3,0,0,0,0,0,4,0,0,0,0,7,0,0,0,0,0.00%,0.079,0.105,0.184,43,7.00%,83,14
Nicolas Aube-Kubel,WSH,W,27,2,5,7,31,4,11:00,10:52,0:01,0:05,2,0,0,0,0,0,5,0,0,1,0,7,0,0,1,0,0.00%,0.074,0.185,0.259,34,5.90%,61,3
Tyler Pitlick,STL,W,36,2,5,7,6,-4,9:24,9:12,0:02,0:09,2,0,0,0,0,0,5,0,0,0,0,7,0,0,0,0,0.00%,0.056,0.139,0.194,22,9.10%,65,16
MacKenzie Entwistle,CHI,C,44,2,5,7,10,-6,11:14,9:52,1:10,0:11,2,0,0,0,0,0,4,1,0,1,0,6,1,0,1,0,14.30%,0.045,0.114,0.159,31,6.50%,82,21
Cole Sillinger,CBJ,C,47,2,5,7,18,-14,13:16,11:49,0:44,0:42,1,1,0,0,0,0,5,0,0,1,1,6,1,0,1,1,14.30%,0.043,0.106,0.149,64,3.10%,72,31
Scott Harrington,SJS,D,22,1,6,7,6,-5,15:09,14:23,0:05,0:40,1,0,0,1,0,0,6,0,0,1,0,7,0,0,2,0,0.00%,0.045,0.273,0.318,19,5.30%,35,35
Henri Jokiharju,BUF,D,28,1,6,7,12,2,20:56,18:19,0:15,2:22,1,0,0,0,0,0,6,0,0,0,0,7,0,0,0,0,0.00%,0.036,0.214,0.25,36,2.80%,26,35
Zach Whitecloud,VGK,D,32,1,6,7,23,0,16:44,15:07,0:00,1:37,1,0,0,0,0,0,6,0,0,2,0,7,0,0,2,0,0.00%,0.031,0.188,0.219,28,3.60%,52,59
Cody Ceci,EDM,D,52,1,6,7,16,10,20:23,17:12,0:05,3:06,1,0,0,0,0,0,6,0,0,1,0,7,0,0,1,0,0.00%,0.019,0.115,0.135,58,1.70%,93,79
Erik Johnson,COL,D,50,0,7,7,10,5,17:51,15:43,0:01,2:06,0,0,0,0,0,0,6,0,1,1,0,6,0,1,1,0,0.00%,0,0.14,0.14,80,0.00%,96,77
Joel Kiviranta,DAL,W,52,6,0,6,30,-9,12:13,10:30,0:02,1:40,5,0,1,0,0,0,0,0,0,0,0,5,0,1,0,0,0.00%,0.115,0,0.115,70,8.60%,84,15
Rafael Harvey-Pinard,MTL,W,7,5,1,6,2,4,14:02,12:32,0:09,1:21,4,0,1,0,0,0,1,0,0,0,0,5,0,1,0,0,0.00%,0.714,0.143,0.857,14,35.70%,22,6
Jack Studnicka,VAN,W,31,4,2,6,10,-7,10:33,10:11,0:11,0:10,4,0,0,1,0,0,2,0,0,0,0,6,0,0,1,0,0.00%,0.129,0.065,0.194,48,8.30%,27,11
Reese Johnson,CHI,W,41,4,2,6,31,-9,10:23,9:14,0:02,1:06,4,0,0,1,0,0,2,0,0,0,0,6,0,0,1,0,0.00%,0.098,0.049,0.146,33,12.10%,122,14
Austin Watson,OTT,W,48,4,2,6,56,-10,10:11,8:10,0:01,2:00,2,0,2,0,0,0,2,0,0,1,0,4,0,2,1,0,0.00%,0.083,0.042,0.125,49,8.20%,105,35
Artyom Zub,OTT,D,21,3,3,6,12,0,21:01,19:20,0:10,1:31,3,0,0,0,0,0,3,0,0,0,0,6,0,0,0,0,0.00%,0.143,0.143,0.286,22,13.60%,67,23
Brad Hunt,COL,D,26,3,3,6,8,2,11:30,11:21,0:05,0:03,3,0,0,0,0,0,3,0,0,0,0,6,0,0,0,0,0.00%,0.115,0.115,0.231,27,11.10%,10,7
Vitaly Kravtsov,NYR,W,28,3,3,6,6,6,11:25,10:51,0:34,0:00,3,0,0,0,0,0,2,1,0,1,0,5,1,0,1,0,16.70%,0.107,0.107,0.214,26,11.50%,11,8
Jujhar Khaira,CHI,W,29,3,3,6,18,-5,13:16,10:47,0:47,1:42,1,1,1,0,0,0,2,1,0,0,0,3,2,1,0,0,33.30%,0.103,0.103,0.207,29,10.30%,51,18
Michael Pezzetta,MTL,W,32,3,3,6,32,-4,8:41,8:15,0:00,0:26,3,0,0,0,0,0,2,1,0,0,0,5,1,0,0,0,16.70%,0.094,0.094,0.188,34,8.80%,112,10
Jonah Gadjovich,SJS,W,34,3,3,6,57,-4,9:02,8:59,0:02,0:00,3,0,0,0,0,0,3,0,0,0,0,6,0,0,0,0,0.00%,0.088,0.088,0.176,32,9.40%,89,5
Jeremy Lauzon,NSH,D,42,3,3,6,55,-2,16:02,13:53,0:01,2:06,3,0,0,0,0,0,2,0,1,1,0,5,0,1,1,0,0.00%,0.071,0.071,0.143,54,5.60%,152,47
Simon Benoit,ANA,D,49,3,3,6,41,-15,18:48,15:46,0:01,3:00,3,0,0,0,0,0,3,0,0,0,0,6,0,0,0,0,0.00%,0.061,0.061,0.122,55,5.50%,141,83
Bowen Byram,COL,D,12,2,4,6,8,2,20:44,18:31,1:09,1:02,1,0,1,0,0,0,3,1,0,0,0,4,1,1,0,0,16.70%,0.167,0.333,0.5,13,15.40%,21,14
Daniil Miromanov,VGK,W,14,2,4,6,2,-6,17:02,15:40,1:16,0:04,1,1,0,0,0,0,2,2,0,0,0,3,3,0,0,0,50.00%,0.143,0.286,0.429,22,9.10%,7,13
Tyler Bertuzzi,DET,W,19,2,4,6,6,-10,16:02,13:19,2:41,0:00,2,0,0,0,0,0,2,2,0,0,0,4,2,0,0,0,33.30%,0.105,0.211,0.316,38,5.30%,18,9
Josh Manson,COL,D,21,2,4,6,40,2,16:57,14:54,0:00,2:02,2,0,0,2,0,0,4,0,0,0,0,6,0,0,2,0,0.00%,0.095,0.19,0.286,30,6.70%,46,23
Gavin Bayreuther,CBJ,D,22,2,4,6,15,-5,15:12,14:11,0:01,0:59,2,0,0,0,0,0,4,0,0,0,0,6,0,0,0,0,0.00%,0.091,0.182,0.273,27,7.40%,29,29
Boris Katchouk,CHI,W,26,2,4,6,23,-2,9:45,9:18,0:03,0:23,2,0,0,1,0,0,4,0,0,0,0,6,0,0,1,0,0.00%,0.077,0.154,0.231,19,10.50%,46,6
Denis Malgin,COL,W,34,2,4,6,6,-5,11:31,10:27,1:03,0:00,2,0,0,0,0,0,3,1,0,1,0,5,1,0,1,0,16.70%,0.059,0.118,0.176,65,3.10%,42,7
Jordan Greenway,MIN,W,34,2,4,6,18,-4,13:36,12:41,0:36,0:19,2,0,0,0,0,0,4,0,0,1,0,6,0,0,1,0,0.00%,0.059,0.118,0.176,51,3.90%,61,17
Nils Åman,VAN,W,38,2,4,6,4,-8,12:03,10:58,0:05,0:58,2,0,0,0,0,0,4,0,0,0,0,6,0,0,0,0,0.00%,0.053,0.105,0.158,28,7.10%,27,22
Jakub Vorácek,CBJ,W,11,1,5,6,0,-7,15:57,12:47,3:09,0:00,0,1,0,0,0,0,5,0,0,3,1,5,1,0,3,1,16.70%,0.091,0.455,0.545,17,5.90%,2,7
Jake Bean,CBJ,D,14,1,5,6,6,-2,15:42,14:16,1:08,0:16,1,0,0,0,0,0,4,1,0,0,0,5,1,0,0,0,16.70%,0.071,0.357,0.429,16,6.30%,13,21
Mason Appleton,WPG,W,14,1,5,6,6,1,16:34,14:38,0:01,1:54,1,0,0,0,0,0,5,0,0,2,1,6,0,0,2,1,0.00%,0.071,0.357,0.429,23,4.40%,26,3
Joel Edmundson,MTL,D,39,1,5,6,39,-21,19:50,15:52,0:07,3:50,1,0,0,0,0,0,5,0,0,1,1,6,0,0,1,1,0.00%,0.026,0.128,0.154,53,1.90%,64,110
Jayson Megna,ANA,W,40,1,5,6,6,-11,9:19,8:23,0:00,0:55,1,0,0,0,0,0,5,0,0,0,0,6,0,0,0,0,0.00%,0.025,0.125,0.15,24,4.20%,41,13
Alexander Edler,LAK,D,45,1,5,6,24,-7,15:12,13:42,0:02,1:27,1,0,0,1,0,0,5,0,0,1,0,6,0,0,2,0,0.00%,0.022,0.111,0.133,46,2.20%,85,79
Johnathan Kovacevic,MTL,D,46,1,5,6,22,1,16:42,14:47,0:01,1:53,1,0,0,0,0,0,5,0,0,1,0,6,0,0,1,0,0.00%,0.022,0.109,0.13,51,2.00%,52,49
Philip Broberg,EDM,D,26,0,6,6,2,11,13:35,12:14,0:07,1:13,0,0,0,0,0,0,6,0,0,2,0,6,0,0,2,0,0.00%,0,0.231,0.231,19,0.00%,14,22
Ryan Reaves,MIN,W,44,0,6,6,26,-4,9:14,9:14,0:00,0:00,0,0,0,0,0,0,6,0,0,1,0,6,0,0,1,0,0.00%,0,0.136,0.136,20,0.00%,117,16
Marc Staal,FLA,D,54,0,6,6,16,0,18:16,15:26,0:02,2:47,0,0,0,0,0,0,6,0,0,0,0,6,0,0,0,0,0.00%,0,0.111,0.111,34,0.00%,97,78
Robby Fabbri,DET,W,14,4,1,5,6,0,16:12,14:04,2:05,0:02,3,1,0,3,1,0,1,0,0,0,0,4,1,0,3,1,20.00%,0.286,0.071,0.357,21,19.10%,25,7
Brandon Duhaime,MIN,W,28,4,1,5,33,3,9:46,8:52,0:03,0:50,3,0,1,1,0,0,1,0,0,0,0,4,0,1,1,0,0.00%,0.143,0.036,0.179,41,9.80%,84,8
Mark Kastelic,OTT,W,43,4,1,5,44,-10,9:14,8:15,0:23,0:35,4,0,0,2,0,0,1,0,0,0,0,5,0,0,2,0,0.00%,0.093,0.023,0.116,48,8.30%,105,29
Rudolfs Balcers,TBL,W,17,3,2,5,4,-1,10:12,9:45,0:21,0:05,3,0,0,0,0,0,2,0,0,0,0,5,0,0,0,0,0.00%,0.176,0.118,0.294,24,12.50%,7,4
Nikita Alexandrov,STL,C,18,3,2,5,8,5,8:46,8:44,0:01,0:00,3,0,0,0,0,0,2,0,0,0,0,5,0,0,0,0,0.00%,0.167,0.111,0.278,18,16.70%,15,10
Drew O'Connor,PIT,W,18,3,2,5,2,-1,8:41,8:13,0:00,0:28,3,0,0,0,0,0,2,0,0,0,0,5,0,0,0,0,0.00%,0.167,0.111,0.278,20,15.00%,31,5
Rem Pitlick,MTL,W,21,3,2,5,14,-10,12:00,10:39,0:41,0:40,3,0,0,1,1,0,2,0,0,0,0,5,0,0,1,1,0.00%,0.143,0.095,0.238,15,20.00%,8,10
Hudson Fasching,NYI,W,22,3,2,5,6,3,12:16,12:01,0:15,0:00,3,0,0,0,0,0,2,0,0,1,0,5,0,0,1,0,0.00%,0.136,0.091,0.227,24,12.50%,27,7
Jansen Harkins,WPG,W,22,3,2,5,12,4,10:49,10:45,0:03,0:00,3,0,0,0,0,0,2,0,0,0,0,5,0,0,0,0,0.00%,0.136,0.091,0.227,18,16.70%,16,11
Kevin Stenlund,WPG,C,24,3,2,5,8,0,12:26,10:07,0:37,1:42,3,0,0,0,0,0,2,0,0,0,0,5,0,0,0,0,0.00%,0.125,0.083,0.208,31,9.70%,12,10
Noah Gregor,SJS,W,28,3,2,5,15,0,12:39,12:30,0:02,0:06,3,0,0,0,0,0,2,0,0,0,0,5,0,0,0,0,0.00%,0.107,0.071,0.179,55,5.50%,43,20
Sam Carrick,ANA,W,36,3,2,5,46,-13,10:23,9:16,0:14,0:52,3,0,0,0,0,0,2,0,0,0,0,5,0,0,0,0,0.00%,0.083,0.056,0.139,40,7.50%,71,19
Josh Brown,ARI,D,48,3,2,5,49,-9,15:20,12:38,0:01,2:40,3,0,0,0,0,0,2,0,0,0,0,5,0,0,0,0,0.00%,0.063,0.042,0.104,41,7.30%,102,80
Nick Robertson,TOR,W,15,2,3,5,0,2,10:53,9:40,1:10,0:01,2,0,0,1,1,0,3,0,0,1,0,5,0,0,2,1,0.00%,0.133,0.2,0.333,27,7.40%,18,7
Jarred Tinordi,CHI,W,25,2,3,5,15,-4,16:46,15:05,0:01,1:39,2,0,0,1,0,0,3,0,0,0,0,5,0,0,1,0,0.00%,0.08,0.12,0.2,17,11.80%,92,37
Nicklas Bäckström,WSH,W,10,1,4,5,2,-5,16:03,13:20,2:39,0:03,0,1,0,0,0,1,4,0,0,0,0,4,1,0,0,0,20.00%,0.1,0.4,0.5,22,4.60%,9,7
Tanner Pearson,VAN,W,14,1,4,5,21,-9,13:29,11:27,1:29,0:32,1,0,0,0,0,0,3,1,0,0,0,4,1,0,0,0,20.00%,0.071,0.286,0.357,17,5.90%,20,3
Ian Mitchell,CHI,D,18,1,4,5,4,-8,16:16,15:00,1:09,0:06,1,0,0,0,0,0,4,0,0,2,0,5,0,0,2,0,0.00%,0.056,0.222,0.278,15,6.70%,4,25
Liam O'Brien,ARI,W,29,1,4,5,40,-1,11:59,10:49,0:02,1:07,1,0,0,0,0,0,4,0,0,0,0,5,0,0,0,0,0.00%,0.034,0.138,0.172,18,5.60%,107,15
Mattias Samuelsson,BUF,D,35,1,4,5,14,10,21:56,18:59,0:03,2:53,1,0,0,0,0,0,3,0,1,2,0,4,0,1,2,0,0.00%,0.029,0.114,0.143,48,2.10%,63,57
Riley Stillman,VAN,D,27,0,5,5,21,-10,15:37,14:21,0:01,1:13,0,0,0,0,0,0,5,0,0,0,0,5,0,0,0,0,0.00%,0,0.185,0.185,26,0.00%,42,26
David Gustafsson,WPG,C,38,0,5,5,6,0,10:11,8:27,0:03,1:40,0,0,0,0,0,0,4,0,1,1,0,4,0,1,1,0,0.00%,0,0.132,0.132,36,0.00%,17,17
Samuel Blais,NYR,W,40,0,5,5,8,1,9:37,9:22,0:15,0:00,0,0,0,0,0,0,5,0,0,1,0,5,0,0,1,0,0.00%,0,0.125,0.125,31,0.00%,119,16
Brendan Smith,NJD,D,49,0,5,5,55,-1,15:25,13:45,0:01,1:37,0,0,0,0,0,0,4,0,1,1,0,4,0,1,1,0,0.00%,0,0.102,0.102,45,0.00%,88,57
Alexander Holtz,NJD,W,19,3,1,4,8,-6,10:16,8:36,1:39,0:00,1,2,0,0,0,0,1,0,0,0,0,2,2,0,0,0,50.00%,0.158,0.053,0.211,21,14.30%,6,4
Simon Holmström,NYI,W,27,3,1,4,0,0,11:16,10:57,0:06,0:13,3,0,0,1,0,0,1,0,0,0,0,4,0,0,1,0,0.00%,0.111,0.037,0.148,20,15.00%,3,12
Zac Dalpe,FLA,W,11,2,2,4,2,-4,9:31,9:13,0:06,0:11,2,0,0,0,0,0,2,0,0,0,0,4,0,0,0,0,0.00%,0.182,0.182,0.364,14,14.30%,12,6
Robin Salo,NYI,D,11,2,2,4,4,1,11:10,10:27,0:41,0:01,2,0,0,0,0,0,2,0,0,0,0,4,0,0,0,0,0.00%,0.182,0.182,0.364,9,22.20%,6,13
Tanner Laczynski,PHI,W,19,2,2,4,2,1,10:12,9:49,0:21,0:02,2,0,0,0,0,0,2,0,0,1,0,4,0,0,1,0,0.00%,0.105,0.105,0.211,14,14.30%,12,5
Jordan Oesterle,DET,D,35,2,2,4,6,-1,15:20,15:06,0:01,0:13,2,0,0,0,0,0,2,0,0,1,0,4,0,0,1,0,0.00%,0.057,0.057,0.114,38,5.30%,27,40
Curtis Lazar,VAN,W,42,2,2,4,14,-5,12:16,11:09,0:03,1:03,2,0,0,0,0,0,2,0,0,0,0,4,0,0,0,0,0.00%,0.048,0.048,0.095,51,3.90%,114,44
Luke Glendening,DAL,W,53,2,2,4,44,-9,12:18,9:41,0:03,2:33,1,0,1,0,0,0,2,0,0,0,0,3,0,1,0,0,0.00%,0.038,0.038,0.075,45,4.40%,84,51
Ty Smith,PIT,D,9,1,3,4,4,3,20:12,14:46,5:24,0:00,1,0,0,0,0,0,0,3,0,1,0,1,3,0,1,0,75.00%,0.111,0.333,0.444,27,3.70%,19,4
Isaak Phillips,CHI,D,11,1,3,4,5,-7,15:45,14:40,0:01,1:04,1,0,0,0,0,0,3,0,0,1,0,4,0,0,1,0,0.00%,0.091,0.273,0.364,13,7.70%,21,4
Fredrik Olofsson,DAL,W,13,1,3,4,2,-1,9:42,9:39,0:02,0:00,1,0,0,1,0,0,3,0,0,0,0,4,0,0,1,0,0.00%,0.077,0.231,0.308,17,5.90%,12,1
Vasili Podkolzin,VAN,W,19,1,3,4,9,0,12:53,12:30,0:20,0:02,1,0,0,0,0,0,3,0,0,0,0,4,0,0,0,0,0.00%,0.053,0.158,0.211,25,4.00%,27,8
Matt Kiersted,FLA,D,20,1,3,4,6,4,9:50,9:26,0:00,0:24,1,0,0,0,0,0,3,0,0,0,0,4,0,0,0,0,0.00%,0.05,0.15,0.2,14,7.10%,13,7
Ben Harpur,NYR,D,21,1,3,4,8,-1,13:24,13:22,0:00,0:01,1,0,0,0,0,0,3,0,0,0,0,4,0,0,0,0,0.00%,0.048,0.143,0.19,17,5.90%,30,32
Brett Howden,VGK,W,26,1,3,4,17,2,13:11,12:30,0:00,0:40,1,0,0,0,0,0,3,0,0,0,0,4,0,0,0,0,0.00%,0.038,0.115,0.154,24,4.20%,43,19
Nathan Walker,STL,W,28,1,3,4,13,0,9:28,9:01,0:04,0:22,1,0,0,1,0,0,3,0,0,0,0,4,0,0,1,0,0.00%,0.036,0.107,0.143,16,6.30%,34,20
Patrick Brown,PHI,W,34,1,3,4,13,-4,11:20,9:53,0:02,1:23,1,0,0,0,0,0,3,0,0,1,0,4,0,0,1,0,0.00%,0.029,0.088,0.118,35,2.90%,99,28
Parker Kelly,OTT,W,48,1,3,4,33,-6,10:20,8:12,0:01,2:06,1,0,0,1,0,0,2,0,1,0,0,3,0,1,1,0,0.00%,0.021,0.063,0.083,51,2.00%,148,18
Alex Belzile,MTL,W,5,0,4,4,0,1,11:17,10:48,0:05,0:23,0,0,0,0,0,0,4,0,0,0,0,4,0,0,0,0,0.00%,0,0.8,0.8,5,0.00%,5,3
Vincent Desharnais,EDM,D,10,0,4,4,12,7,12:02,9:56,0:05,2:00,0,0,0,0,0,0,4,0,0,2,0,4,0,0,2,0,0.00%,0,0.4,0.4,5,0.00%,9,9
Nick Cicek,SJS,D,14,0,4,4,15,-7,14:29,13:58,0:02,0:28,0,0,0,0,0,0,4,0,0,0,0,4,0,0,0,0,0.00%,0,0.286,0.286,1,0.00%,23,16
Justin Barron,MTL,D,14,0,4,4,6,-4,16:03,14:55,0:39,0:28,0,0,0,0,0,0,4,0,0,1,0,4,0,0,1,0,0.00%,0,0.286,0.286,12,0.00%,13,11
Nikita Zaitsev,OTT,D,23,0,4,4,8,-3,16:58,14:07,0:00,2:50,0,0,0,0,0,0,4,0,0,1,0,4,0,0,1,0,0.00%,0,0.174,0.174,10,0.00%,49,37
Nathan Beaulieu,ANA,D,25,0,4,4,30,-13,13:39,11:49,0:00,1:49,0,0,0,0,0,0,4,0,0,0,0,4,0,0,0,0,0.00%,0,0.16,0.16,14,0.00%,33,43
Kurtis MacDermid,COL,D,29,0,4,4,38,-1,7:39,7:33,0:00,0:06,0,0,0,0,0,0,4,0,0,1,0,4,0,0,1,0,0.00%,0,0.138,0.138,10,0.00%,71,13
Chris Wideman,MTL,D,30,0,4,4,61,3,13:40,12:00,1:40,0:00,0,0,0,0,0,0,2,2,0,0,0,2,2,0,0,0,50.00%,0,0.133,0.133,24,0.00%,16,36
Erik Brännström,OTT,D,45,0,4,4,20,-4,15:06,13:18,0:40,1:07,0,0,0,0,0,0,4,0,0,0,0,4,0,0,0,0,0.00%,0,0.089,0.089,44,0.00%,30,66
Patrik Nemeth,ARI,D,47,0,4,4,22,-2,15:52,13:05,0:01,2:46,0,0,0,0,0,0,4,0,0,1,0,4,0,0,1,0,0.00%,0,0.085,0.085,31,0.00%,72,61
Jack Johnson,CHI,D,50,0,4,4,14,-21,19:58,17:40,0:02,2:15,0,0,0,0,0,0,3,0,1,0,0,3,0,1,0,0,0.00%,0,0.08,0.08,55,0.00%,63,83
Troy Stecher,ARI,D,52,0,4,4,23,-3,16:16,13:33,0:03,2:38,0,0,0,0,0,0,4,0,0,1,0,4,0,0,1,0,0.00%,0,0.077,0.077,50,0.00%,53,71
Max Pacioretty,CAR,W,5,3,0,3,2,0,13:38,9:45,3:53,0:00,2,1,0,0,0,0,0,0,0,0,0,2,1,0,0,0,33.30%,0.6,0,0.6,16,18.80%,4,1
Jordan Gross,NSH,D,10,3,0,3,2,-3,18:48,16:01,2:27,0:20,2,1,0,0,0,0,0,0,0,0,0,2,1,0,0,0,33.30%,0.3,0,0.3,20,15.00%,10,12
Dryden Hunt,TOR,W,37,3,0,3,24,-10,8:04,8:02,0:02,0:00,3,0,0,0,0,0,0,0,0,0,0,3,0,0,0,0,0.00%,0.081,0,0.081,23,13.00%,100,4
Justin Danforth,CBJ,W,6,2,1,3,4,-3,13:23,10:55,1:51,0:36,2,0,0,0,0,0,1,0,0,0,0,3,0,0,0,0,0.00%,0.333,0.167,0.5,10,20.00%,7,1
Tom Wilson,WSH,W,8,2,1,3,8,-7,14:54,12:24,1:47,0:42,1,1,0,0,0,0,1,0,0,0,0,2,1,0,0,0,33.30%,0.25,0.125,0.375,13,15.40%,33,3
Joshua Norris,OTT,W,8,2,1,3,6,-1,17:59,13:13,3:06,1:39,2,0,0,0,0,0,1,0,0,0,0,3,0,0,0,0,0.00%,0.25,0.125,0.375,15,13.30%,7,6
Michael Carcone,ARI,W,9,2,1,3,2,3,12:38,12:17,0:21,0:00,2,0,0,0,0,0,1,0,0,0,0,3,0,0,0,0,0.00%,0.222,0.111,0.333,15,13.30%,16,1
Samuel Fagemo,LAK,W,9,2,1,3,0,-4,7:51,7:51,0:00,0:00,2,0,0,0,0,0,1,0,0,0,0,3,0,0,0,0,0.00%,0.222,0.111,0.333,5,40.00%,5,6
Connor Mackey,CGY,D,10,2,1,3,9,-6,10:17,10:01,0:00,0:15,2,0,0,0,0,0,1,0,0,0,0,3,0,0,0,0,0.00%,0.2,0.1,0.3,8,25.00%,11,5
Chris Tierney,FLA,W,11,2,1,3,0,0,8:44,8:16,0:06,0:21,2,0,0,0,0,0,1,0,0,0,0,3,0,0,0,0,0.00%,0.182,0.091,0.273,5,40.00%,10,7
Austin Czarnik,DET,W,12,2,1,3,2,1,11:27,10:50,0:36,0:00,2,0,0,0,0,0,1,0,0,0,0,3,0,0,0,0,0.00%,0.167,0.083,0.25,13,15.40%,12,6
Joey Anderson,TOR,W,12,2,1,3,0,2,9:25,9:06,0:16,0:03,2,0,0,0,0,0,1,0,0,0,0,3,0,0,0,0,0.00%,0.167,0.083,0.25,9,22.20%,16,6
Derek Grant,ANA,W,17,2,1,3,8,-6,13:45,11:14,0:01,2:29,2,0,0,0,0,0,1,0,0,0,0,3,0,0,0,0,0.00%,0.118,0.059,0.176,26,7.70%,18,12
Ben Hutton,VGK,D,22,2,1,3,6,-2,15:23,14:40,0:30,0:12,2,0,0,0,0,0,0,1,0,0,0,2,1,0,0,0,33.30%,0.091,0.045,0.136,43,4.70%,11,19
Lukas Reichel,CHI,W,4,1,2,3,0,2,14:27,13:21,1:06,0:00,1,0,0,0,0,0,2,0,0,1,1,3,0,0,1,1,0.00%,0.25,0.5,0.75,8,12.50%,2,2
Jakub Lauko,BOS,W,8,1,2,3,2,0,9:57,9:11,0:01,0:43,1,0,0,0,0,0,2,0,0,1,0,3,0,0,1,0,0.00%,0.125,0.25,0.375,8,12.50%,17,2
Aleksi Heponiemi,FLA,W,10,1,2,3,2,-1,8:35,8:29,0:04,0:01,1,0,0,0,0,0,2,0,0,0,0,3,0,0,0,0,0.00%,0.1,0.2,0.3,6,16.70%,2,1
Philippe Myers,TBL,D,11,1,2,3,4,0,11:32,11:01,0:00,0:30,1,0,0,0,0,0,2,0,0,0,0,3,0,0,0,0,0.00%,0.091,0.182,0.273,21,4.80%,31,6
Lane Pederson,VAN,C,11,1,2,3,15,3,12:50,12:03,0:47,0:00,1,0,0,0,0,0,2,0,0,0,0,3,0,0,0,0,0.00%,0.091,0.182,0.273,15,6.70%,21,7
Pavol Regenda,ANA,W,14,1,2,3,4,-3,10:32,9:49,0:40,0:02,1,0,0,0,0,0,2,0,0,0,0,3,0,0,0,0,0.00%,0.071,0.143,0.214,17,5.90%,8,13
Filip Roos,CHI,D,15,1,2,3,4,-7,16:18,15:00,0:59,0:18,1,0,0,0,0,0,2,0,0,0,0,3,0,0,0,0,0.00%,0.067,0.133,0.2,17,5.90%,11,17
Lawrence Pilut,BUF,D,17,1,2,3,0,-4,12:47,11:48,0:00,0:58,1,0,0,1,0,0,2,0,0,0,0,3,0,0,1,0,0.00%,0.059,0.118,0.176,14,7.10%,6,16
Givani Smith,FLA,W,19,1,2,3,45,2,7:24,7:23,0:00,0:00,1,0,0,0,0,0,2,0,0,0,0,3,0,0,0,0,0.00%,0.053,0.105,0.158,21,4.80%,43,3
Alex Goligoski,MIN,D,21,1,2,3,0,-3,17:26,15:51,0:17,1:18,1,0,0,1,1,0,2,0,0,0,0,3,0,0,1,1,0.00%,0.048,0.095,0.143,33,3.00%,20,29
Ryan Carpenter,NYR,C,21,1,2,3,10,-5,9:36,8:28,0:03,1:04,1,0,0,0,0,0,2,0,0,0,0,3,0,0,0,0,0.00%,0.048,0.095,0.143,17,5.90%,35,11
Patric Hörnqvist,FLA,W,22,1,2,3,13,-4,9:16,7:03,2:12,0:00,1,0,0,1,0,0,1,1,0,0,0,2,1,0,1,0,33.30%,0.045,0.091,0.136,40,2.50%,18,8
Callan Foote,TBL,D,22,1,2,3,26,4,14:23,13:28,0:19,0:35,1,0,0,0,0,0,2,0,0,0,0,3,0,0,0,0,0.00%,0.045,0.091,0.136,15,6.70%,35,17
Martin Kaut,COL,W,27,1,2,3,4,-2,9:08,8:11,0:41,0:15,1,0,0,1,0,0,2,0,0,0,0,3,0,0,1,0,0.00%,0.037,0.074,0.111,24,4.20%,15,5
Grigory Denisenko,FLA,W,12,0,3,3,0,-4,11:19,10:44,0:35,0:00,0,0,0,0,0,0,3,0,0,1,0,3,0,0,1,0,0.00%,0,0.25,0.25,12,0.00%,18,7
Ryan Murray,EDM,D,13,0,3,3,4,-4,13:07,12:22,0:00,0:44,0,0,0,0,0,0,3,0,0,0,0,3,0,0,0,0,0.00%,0,0.231,0.231,8,0.00%,11,12
Robert Hägg,DET,D,14,0,3,3,10,-8,15:27,14:31,0:04,0:52,0,0,0,0,0,0,3,0,0,1,0,3,0,0,1,0,0.00%,0,0.214,0.214,20,0.00%,41,18
Dylan Coghlan,CAR,D,16,0,3,3,2,-1,12:44,11:32,1:07,0:04,0,0,0,0,0,0,3,0,0,0,0,3,0,0,0,0,0.00%,0,0.188,0.188,28,0.00%,11,9
Casey Fitzgerald,BUF,D,23,0,3,3,4,-1,13:03,11:14,0:00,1:48,0,0,0,0,0,0,3,0,0,0,0,3,0,0,0,0,0.00%,0,0.13,0.13,12,0.00%,29,12
Brendan Lemieux,LAK,W,26,0,3,3,53,-6,8:31,8:24,0:06,0:01,0,0,0,0,0,0,3,0,0,0,0,3,0,0,0,0,0.00%,0,0.115,0.115,22,0.00%,76,8
Andreas Englund,COL,D,29,0,3,3,19,1,11:08,10:40,0:00,0:28,0,0,0,0,0,0,3,0,0,0,0,3,0,0,0,0,0.00%,0,0.103,0.103,15,0.00%,86,16
Devin Shore,EDM,W,29,0,3,3,2,2,8:42,8:14,0:02,0:25,0,0,0,0,0,0,3,0,0,0,0,3,0,0,0,0,0.00%,0,0.103,0.103,17,0.00%,33,16
Liam Foudy,CBJ,W,32,0,3,3,4,-18,11:08,10:17,0:00,0:50,0,0,0,0,0,0,3,0,0,0,0,3,0,0,0,0,0.00%,0,0.094,0.094,24,0.00%,38,10
Niko Mikkola,NYR,D,51,0,3,3,41,1,16:35,14:44,0:01,1:49,0,0,0,0,0,0,3,0,0,1,0,3,0,0,1,0,0.00%,0,0.059,0.059,32,0.00%,100,69
Walker Duehr,CGY,W,8,2,0,2,0,-1,9:10,9:06,0:03,0:00,2,0,0,0,0,0,0,0,0,0,0,2,0,0,0,0,0.00%,0.25,0,0.25,12,16.70%,16,1
Aatu Räty,NYI,W,12,2,0,2,4,1,8:45,8:11,0:34,0:00,2,0,0,0,0,0,0,0,0,0,0,2,0,0,0,0,0.00%,0.167,0,0.167,16,12.50%,17,4
Kyle Burroughs,VAN,D,22,2,0,2,30,-12,16:44,15:08,0:01,1:34,2,0,0,0,0,0,0,0,0,0,0,2,0,0,0,0,0.00%,0.091,0,0.091,22,9.10%,67,41
Jakub Vrana,DET,W,2,1,1,2,0,1,11:36,9:24,2:11,0:00,1,0,0,0,0,0,1,0,0,1,0,2,0,0,1,0,0.00%,0.5,0.5,1,5,20.00%,2,0
Phil Di Giuseppe,VAN,W,4,1,1,2,0,-1,11:42,10:49,0:00,0:53,1,0,0,0,0,0,1,0,0,0,0,2,0,0,0,0,0.00%,0.25,0.25,0.5,9,11.10%,6,1
Beck Malenstyn,WSH,W,5,1,1,2,2,2,8:33,8:32,0:01,0:00,1,0,0,1,0,0,1,0,0,0,0,2,0,0,1,0,0.00%,0.2,0.2,0.4,4,25.00%,15,2
Kiefer Sherwood,NSH,W,5,1,1,2,11,1,10:01,9:34,0:27,0:00,1,0,0,0,0,0,1,0,0,0,0,2,0,0,0,0,0.00%,0.2,0.2,0.4,4,25.00%,8,0
Byron Froese,VGK,W,7,1,1,2,2,0,9:59,9:45,0:00,0:14,1,0,0,0,0,0,1,0,0,0,0,2,0,0,0,0,0.00%,0.143,0.143,0.286,11,9.10%,6,4
Anthony Richard,MTL,W,7,1,1,2,2,2,9:59,9:39,0:19,0:00,1,0,0,0,0,0,1,0,0,0,0,2,0,0,0,0,0.00%,0.143,0.143,0.286,6,16.70%,11,1
Zachary Sanford,NSH,W,8,1,1,2,2,-3,12:04,10:11,1:52,0:00,1,0,0,1,0,0,1,0,0,0,0,2,0,0,1,0,0.00%,0.125,0.125,0.25,9,11.10%,9,6
Shane Wright,SEA,W,8,1,1,2,2,4,8:29,8:05,0:23,0:00,1,0,0,0,0,0,1,0,0,0,0,2,0,0,0,0,0.00%,0.125,0.125,0.25,4,25.00%,1,6
Jordie Benn,TOR,D,12,1,1,2,12,-1,15:48,14:02,0:05,1:40,1,0,0,1,0,0,1,0,0,0,0,2,0,0,1,0,0.00%,0.083,0.083,0.167,13,7.70%,31,29
Michael McCarron,NSH,W,15,1,1,2,17,-2,9:50,8:33,0:05,1:11,1,0,0,0,0,0,1,0,0,0,0,2,0,0,0,0,0.00%,0.067,0.067,0.133,21,4.80%,34,13
Jonny Brodzinski,NYR,W,16,1,1,2,8,3,9:21,8:57,0:02,0:22,1,0,0,0,0,0,1,0,0,0,0,2,0,0,0,0,0.00%,0.063,0.063,0.125,26,3.90%,8,3
Zac Jones,NYR,D,16,1,1,2,4,-2,15:36,14:37,0:53,0:05,1,0,0,1,0,0,1,0,0,0,0,2,0,0,1,0,0.00%,0.063,0.063,0.125,15,6.70%,5,16
Kevin Bahl,NJD,D,17,1,1,2,17,-3,11:41,11:13,0:03,0:24,1,0,0,0,0,0,1,0,0,0,0,2,0,0,0,0,0.00%,0.059,0.059,0.118,10,10.00%,21,22
Radim Simek,SJS,D,31,1,1,2,25,-9,14:43,13:25,0:04,1:13,1,0,0,0,0,0,1,0,0,0,0,2,0,0,0,0,0.00%,0.032,0.032,0.065,31,3.20%,62,52
Ridly Greig,OTT,W,4,0,2,2,0,4,14:48,12:28,1:58,0:20,0,0,0,0,0,0,0,2,0,1,0,0,2,0,1,0,100.00%,0,0.5,0.5,11,0.00%,2,2
Mac Hollowell,TOR,D,6,0,2,2,2,3,12:56,12:35,0:03,0:17,0,0,0,0,0,0,2,0,0,0,0,2,0,0,0,0,0.00%,0,0.333,0.333,4,0.00%,3,6
Nic Petan,MIN,W,8,0,2,2,2,3,11:15,10:54,0:21,0:00,0,0,0,0,0,0,2,0,0,0,0,2,0,0,0,0,0.00%,0,0.25,0.25,6,0.00%,3,3
Brayden Pachal,VGK,D,9,0,2,2,6,1,16:33,15:18,0:02,1:12,0,0,0,0,0,0,2,0,0,0,0,2,0,0,0,0,0.00%,0,0.222,0.222,16,0.00%,24,9
Brandt Clarke,LAK,D,9,0,2,2,6,-1,13:38,12:35,0:37,0:26,0,0,0,0,0,0,1,1,0,1,0,1,1,0,1,0,50.00%,0,0.222,0.222,11,0.00%,3,14
Jesse Ylönen,MTL,W,10,0,2,2,0,-4,12:54,11:18,1:23,0:12,0,0,0,0,0,0,2,0,0,0,0,2,0,0,0,0,0.00%,0,0.2,0.2,12,0.00%,3,11
Kaedan Korczak,VGK,D,10,0,2,2,0,-3,17:34,17:05,0:01,0:26,0,0,0,0,0,0,2,0,0,0,0,2,0,0,0,0,0.00%,0,0.2,0.2,16,0.00%,25,8
Ross Johnston,NYI,W,11,0,2,2,14,-1,8:15,8:13,0:01,0:00,0,0,0,0,0,0,2,0,0,1,0,2,0,0,1,0,0.00%,0,0.182,0.182,2,0.00%,24,5
Victor Mete,TOR,D,11,0,2,2,4,3,13:04,12:05,0:06,0:52,0,0,0,0,0,0,2,0,0,1,0,2,0,0,1,0,0.00%,0,0.182,0.182,7,0.00%,3,9
Yegor Zamula,PHI,D,11,0,2,2,0,-1,13:44,13:13,0:26,0:04,0,0,0,0,0,0,2,0,0,1,0,2,0,0,1,0,0.00%,0,0.182,0.182,6,0.00%,6,8
Alexander Alexeyev,WSH,D,12,0,2,2,2,-3,13:50,13:34,0:00,0:15,0,0,0,0,0,0,2,0,0,1,0,2,0,0,1,0,0.00%,0,0.167,0.167,7,0.00%,13,17
Logan Brown,STL,C,13,0,2,2,4,-3,9:42,8:53,0:48,0:00,0,0,0,0,0,0,2,0,0,0,0,2,0,0,0,0,0.00%,0,0.154,0.154,6,0.00%,7,5
Jacob Christiansen,CBJ,D,18,0,2,2,4,-3,13:52,13:45,0:04,0:02,0,0,0,0,0,0,2,0,0,0,0,2,0,0,0,0,0.00%,0,0.111,0.111,21,0.00%,17,19
Kale Clague,BUF,D,21,0,2,2,12,0,16:09,16:01,0:04,0:03,0,0,0,0,0,0,2,0,0,0,0,2,0,0,0,0,0.00%,0,0.095,0.095,16,0.00%,15,19
Gustav Lindström,DET,D,21,0,2,2,8,-10,13:42,13:39,0:01,0:01,0,0,0,0,0,0,2,0,0,1,0,2,0,0,1,0,0.00%,0,0.095,0.095,12,0.00%,27,16
Jack Drury,CAR,C,21,0,2,2,10,4,9:49,9:20,0:14,0:14,0,0,0,0,0,0,2,0,0,0,0,2,0,0,0,0,0.00%,0,0.095,0.095,32,0.00%,6,9
Colton White,ANA,D,22,0,2,2,6,-6,13:08,12:36,0:05,0:26,0,0,0,0,0,0,2,0,0,0,0,2,0,0,0,0,0.00%,0,0.091,0.091,18,0.00%,17,17
Urho Vaakanainen,ANA,D,23,0,2,2,0,-16,16:27,16:00,0:02,0:24,0,0,0,0,0,0,2,0,0,0,0,2,0,0,0,0,0.00%,0,0.087,0.087,27,0.00%,18,28
Ilya Samsonov,TOR,G,25,0,2,2,0,,,,,,0,0,0,0,0,0,,,,,,,,,0,0,0.00%,0,0.08,0.08,,,,
Zach Bogosian,TBL,D,27,0,2,2,14,4,14:23,13:52,0:00,0:31,0,0,0,0,0,0,2,0,0,0,0,2,0,0,0,0,0.00%,0,0.074,0.074,28,0.00%,80,26
Tristan Jarry,PIT,G,27,0,2,2,2,,,,,,0,0,0,0,0,0,,,,,,,,,0,0,0.00%,0,0.074,0.074,,,,
Chad Ruhwedel,PIT,D,32,0,2,2,10,0,14:04,12:23,0:00,1:40,0,0,0,0,0,0,2,0,0,0,0,2,0,0,0,0,0.00%,0,0.063,0.063,23,0.00%,61,32
John Gibson,ANA,G,36,0,2,2,10,,,,,,0,0,0,0,0,0,,,,,,,,,0,0,0.00%,0,0.056,0.056,,,,
Jacob MacDonald,SJS,D,37,0,2,2,13,-4,9:24,9:03,0:17,0:02,0,0,0,0,0,0,2,0,0,0,0,2,0,0,0,0,0.00%,0,0.054,0.054,32,0.00%,37,22
Matt Irwin,WSH,D,38,0,2,2,20,1,12:29,11:55,0:00,0:34,0,0,0,0,0,0,2,0,0,0,0,2,0,0,0,0,0.00%,0,0.053,0.053,47,0.00%,90,44
John Hayden,SEA,W,3,1,0,1,0,1,8:02,8:02,0:00,0:00,1,0,0,0,0,0,0,0,0,0,0,1,0,0,0,0,0.00%,0.333,0,0.333,4,25.00%,1,2
Joseph Cramarossa,MIN,C,4,1,0,1,4,0,7:47,7:42,0:00,0:05,1,0,0,0,0,0,0,0,0,0,0,1,0,0,0,0,0.00%,0.25,0,0.25,1,100.00%,8,1
Samuel Bolduc,NYI,D,6,1,0,1,2,2,15:17,13:36,1:38,0:03,1,0,0,1,0,0,0,0,0,0,0,1,0,0,1,0,0.00%,0.167,0,0.167,6,16.70%,13,5
Samuel Walker,MIN,C,6,1,0,1,0,2,9:49,9:49,0:00,0:00,1,0,0,0,0,0,0,0,0,0,0,1,0,0,0,0,0.00%,0.167,0,0.167,5,20.00%,2,1
Matej Blümel,DAL,W,6,1,0,1,0,-2,9:42,9:32,0:10,0:00,1,0,0,0,0,0,0,0,0,0,0,1,0,0,0,0,0.00%,0.167,0,0.167,7,14.30%,7,2
Matt Luff,DET,W,7,1,0,1,0,-1,8:25,8:25,0:00,0:00,1,0,0,0,0,0,0,0,0,0,0,1,0,0,0,0,0.00%,0.143,0,0.143,5,20.00%,7,3
Kyle Capobianco,WPG,D,9,1,0,1,4,1,12:08,11:21,0:39,0:07,1,0,0,1,0,0,0,0,0,0,0,1,0,0,1,0,0.00%,0.111,0,0.111,6,16.70%,9,4
Filip Zadina,DET,W,10,1,0,1,4,-2,13:24,11:50,1:31,0:02,1,0,0,1,0,0,0,0,0,0,0,1,0,0,1,0,0.00%,0.1,0,0.1,13,7.70%,10,5
Mark Friedman,PIT,D,10,1,0,1,11,3,15:45,14:22,0:00,1:22,1,0,0,0,0,0,0,0,0,0,0,1,0,0,0,0,0.00%,0.1,0,0.1,14,7.10%,26,8
Nikita Okhotyuk,NJD,D,10,1,0,1,2,1,11:44,11:24,0:01,0:19,1,0,0,1,0,0,0,0,0,0,0,1,0,0,1,0,0.00%,0.1,0,0.1,6,16.70%,31,9
Travis Dermott,VAN,D,11,1,0,1,2,-4,13:45,12:35,0:05,1:03,1,0,0,0,0,0,0,0,0,0,0,1,0,0,0,0,0.00%,0.091,0,0.091,7,14.30%,10,10
Jake Lucchini,OTT,W,11,1,0,1,0,-2,11:40,9:52,1:14,0:33,0,1,0,1,0,0,0,0,0,0,0,0,1,0,1,0,100.00%,0.091,0,0.091,14,7.10%,16,1
Jakub Zboril,BOS,D,14,1,0,1,2,-1,13:05,11:25,0:00,1:38,1,0,0,1,0,0,0,0,0,0,0,1,0,0,1,0,0.00%,0.071,0,0.071,8,12.50%,13,12
Libor Hajek,NYR,D,16,1,0,1,4,2,13:15,13:09,0:00,0:06,1,0,0,0,0,0,0,0,0,0,0,1,0,0,0,0,0.00%,0.063,0,0.063,13,7.70%,17,20
Kieffer Bellows,PHI,W,16,1,0,1,6,-4,10:58,10:15,0:43,0:00,1,0,0,0,0,0,0,0,0,0,0,1,0,0,0,0,0.00%,0.063,0,0.063,23,4.40%,34,8
Cole Koepke,TBL,W,17,1,0,1,2,-5,9:06,8:56,0:00,0:09,1,0,0,0,0,0,0,0,0,0,0,1,0,0,0,0,0.00%,0.059,0,0.059,12,8.30%,32,5
Ben Meyers,COL,W,28,1,0,1,6,-5,10:22,10:01,0:19,0:00,1,0,0,0,0,0,0,0,0,0,0,1,0,0,0,0,0.00%,0.036,0,0.036,23,4.40%,19,10
Tim Berni,CBJ,D,29,1,0,1,18,-17,17:54,17:09,0:12,0:32,1,0,0,0,0,0,0,0,0,0,0,1,0,0,0,0,0.00%,0.034,0,0.034,30,3.30%,74,35
Robert Bortuzzo,STL,D,31,1,0,1,25,2,11:58,10:13,0:00,1:45,1,0,0,0,0,0,0,0,0,0,0,1,0,0,0,0,0.00%,0.032,0,0.032,19,5.30%,51,29
Dylan Gambrell,OTT,W,31,1,0,1,25,-6,10:56,9:23,0:00,1:32,1,0,0,0,0,0,0,0,0,0,0,1,0,0,0,0,0.00%,0.032,0,0.032,21,4.80%,32,22
Zack Kassian,ARI,W,35,1,0,1,34,-13,9:13,9:11,0:00,0:01,1,0,0,0,0,0,0,0,0,0,0,1,0,0,0,0,0.00%,0.029,0,0.029,20,5.00%,29,8
Kyle Clifford,TOR,W,2,0,1,1,2,1,7:54,7:54,0:00,0:00,0,0,0,0,0,0,1,0,0,1,0,1,0,0,1,0,0.00%,0,0.5,0.5,2,0.00%,6,0
Kristian Reichel,WPG,W,2,0,1,1,0,0,10:33,10:33,0:00,0:00,0,0,0,0,0,0,1,0,0,1,0,1,0,0,1,0,0.00%,0,0.5,0.5,1,0.00%,2,0
Luke Philp,CHI,C,2,0,1,1,2,1,10:31,10:27,0:04,0:00,0,0,0,0,0,0,1,0,0,1,0,1,0,0,1,0,0.00%,0,0.5,0.5,0,0.00%,3,0
Guillaume Brisebois,VAN,D,3,0,1,1,0,1,16:51,14:36,0:00,2:15,0,0,0,0,0,0,1,0,0,0,0,1,0,0,0,0,0.00%,0,0.333,0.333,3,0.00%,1,4
Tucker Poolman,VAN,D,3,0,1,1,0,1,13:57,12:43,0:04,1:10,0,0,0,0,0,0,1,0,0,0,0,1,0,0,0,0,0.00%,0,0.333,0.333,3,0.00%,2,2
Samuel Poulin,PIT,W,3,0,1,1,2,-3,9:58,8:47,1:11,0:00,0,0,0,0,0,0,0,1,0,0,0,0,1,0,0,0,100.00%,0,0.333,0.333,2,0.00%,3,1
Jake Muzzin,TOR,D,4,0,1,1,2,0,16:42,13:55,0:00,2:46,0,0,0,0,0,0,1,0,0,0,0,1,0,0,0,0,0.00%,0,0.25,0.25,8,0.00%,11,10
Steve Santini,STL,D,4,0,1,1,2,0,12:30,11:46,0:01,0:43,0,0,0,0,0,0,1,0,0,0,0,1,0,0,0,0,0.00%,0,0.25,0.25,5,0.00%,6,10
William Bitten,STL,W,4,0,1,1,0,1,6:38,6:38,0:00,0:00,0,0,0,0,0,0,1,0,0,0,0,1,0,0,0,0,0.00%,0,0.25,0.25,0,0.00%,10,0
Dominic Toninato,WPG,W,4,0,1,1,2,1,7:02,7:02,0:00,0:00,0,0,0,0,0,0,1,0,0,0,0,1,0,0,0,0,0.00%,0,0.25,0.25,5,0.00%,4,1
Brendan Gaunce,CBJ,C,5,0,1,1,2,-1,10:27,10:08,0:14,0:05,0,0,0,0,0,0,1,0,0,0,0,1,0,0,0,0,0.00%,0,0.2,0.2,9,0.00%,4,2
Joona Koppanen,BOS,W,5,0,1,1,4,0,10:49,9:08,0:11,1:30,0,0,0,0,0,0,1,0,0,0,0,1,0,0,0,0,0.00%,0,0.2,0.2,2,0.00%,8,2
Jack Rathbone,VAN,D,6,0,1,1,0,-3,15:25,14:05,1:18,0:01,0,0,0,0,0,0,1,0,0,0,0,1,0,0,0,0,0.00%,0,0.167,0.167,7,0.00%,1,3
Tobias Björnfot,LAK,D,6,0,1,1,4,2,14:29,13:29,0:02,0:57,0,0,0,0,0,0,1,0,0,1,0,1,0,0,1,0,0.00%,0,0.167,0.167,9,0.00%,9,5
Joseph Snively,WSH,W,6,0,1,1,0,0,12:01,11:49,0:11,0:00,0,0,0,0,0,0,1,0,0,0,0,1,0,0,0,0,0.00%,0,0.167,0.167,10,0.00%,3,4
Mike Reilly,BOS,D,10,0,1,1,2,0,16:44,15:25,1:01,0:16,0,0,0,0,0,0,1,0,0,1,0,1,0,0,1,0,0.00%,0,0.1,0.1,12,0.00%,21,10
Logan Stanley,WPG,D,10,0,1,1,13,-2,13:34,12:17,0:00,1:17,0,0,0,0,0,0,1,0,0,0,0,1,0,0,0,0,0.00%,0,0.1,0.1,8,0.00%,26,12
Dennis Gilbert,CGY,D,10,0,1,1,20,-2,10:49,10:26,0:00,0:23,0,0,0,0,0,0,1,0,0,0,0,1,0,0,0,0,0.00%,0,0.1,0.1,6,0.00%,20,10
Ville Heinola,WPG,D,10,0,1,1,2,-5,13:16,12:24,0:50,0:00,0,0,0,0,0,0,1,0,0,1,0,1,0,0,1,0,0.00%,0,0.1,0.1,5,0.00%,7,7
Cale Fleury,SEA,D,11,0,1,1,2,0,12:51,12:34,0:05,0:11,0,0,0,0,0,0,1,0,0,0,0,1,0,0,0,0,0.00%,0,0.091,0.091,10,0.00%,26,13
Parker Wotherspoon,NYI,D,12,0,1,1,4,5,13:19,13:02,0:00,0:17,0,0,0,0,0,0,1,0,0,0,0,1,0,0,0,0,0.00%,0,0.083,0.083,10,0.00%,8,7
Tyler Tucker,STL,D,12,0,1,1,10,-1,14:58,14:51,0:01,0:05,0,0,0,0,0,0,1,0,0,0,0,1,0,0,0,0,0.00%,0,0.083,0.083,12,0.00%,24,12
Brian Elliott,TBL,G,13,0,1,1,0,,,,,,0,0,0,0,0,0,,,,,,,,,0,0,0.00%,0,0.077,0.077,,,,
Wayne Simmonds,TOR,W,13,0,1,1,34,0,7:24,7:23,0:01,0:00,0,0,0,0,0,0,1,0,0,1,0,1,0,0,1,0,0.00%,0,0.077,0.077,7,0.00%,33,7
Eric Comrie,BUF,G,13,0,1,1,0,,,,,,0,0,0,0,0,0,,,,,,,,,0,0,0.00%,0,0.077,0.077,,,,
Jonas Røndbjerg,VGK,W,13,0,1,1,4,-5,10:10,9:33,0:00,0:36,0,0,0,0,0,0,1,0,0,0,0,1,0,0,0,0,0.00%,0,0.077,0.077,15,0.00%,2,7
William Lockwood,VAN,W,13,0,1,1,0,-7,10:16,9:40,0:04,0:31,0,0,0,0,0,0,1,0,0,0,0,1,0,0,0,0,0.00%,0,0.077,0.077,12,0.00%,37,13
Collin Delia,VAN,G,13,0,1,1,0,,,,,,0,0,0,0,0,0,,,,,,,,,0,0,0.00%,0,0.077,0.077,,,,
Jacob Bernard-Docker,OTT,D,13,0,1,1,9,-3,17:18,16:56,0:00,0:20,0,0,0,0,0,0,1,0,0,0,0,1,0,0,0,0,0.00%,0,0.077,0.077,15,0.00%,16,23
Pavel Francouz,COL,G,15,0,1,1,0,,,,,,0,0,0,0,0,0,,,,,,,,,0,0,0.00%,0,0.067,0.067,,,,
Marco Rossi,MIN,C,16,0,1,1,6,-4,12:26,11:01,1:15,0:09,0,0,0,0,0,0,1,0,0,0,0,1,0,0,0,0,0.00%,0,0.063,0.063,11,0.00%,4,7
Craig Anderson,BUF,G,17,0,1,1,0,,,,,,0,0,0,0,0,0,,,,,,,,,0,0,0.00%,0,0.059,0.059,,,,
Kevin Rooney,CGY,W,17,0,1,1,7,-2,8:51,8:31,0:05,0:14,0,0,0,0,0,0,1,0,0,0,0,1,0,0,0,0,0.00%,0,0.059,0.059,14,0.00%,26,10
Spencer Knight,FLA,G,19,0,1,1,0,,,,,,0,0,0,0,0,0,,,,,,,,,0,0,0.00%,0,0.053,0.053,,,,
Pheonix Copley,LAK,G,20,0,1,1,0,,,,,,0,0,0,0,0,0,,,,,,,,,0,0,0.00%,0,0.05,0.05,,,,
Haydn Fleury,TBL,D,20,0,1,1,2,-4,12:07,11:07,0:01,0:58,0,0,0,0,0,0,1,0,0,0,0,1,0,0,0,0,0.00%,0,0.05,0.05,18,0.00%,22,20
Adin Hill,VGK,G,20,0,1,1,2,,,,,,0,0,0,0,0,0,,,,,,,,,0,0,0.00%,0,0.05,0.05,,,,
Filip Gustavsson,MIN,G,21,0,1,1,0,,,,,,0,0,0,0,0,0,,,,,,,,,0,0,0.00%,0,0.048,0.048,,,,
Petr Mrazek,CHI,G,22,0,1,1,4,,,,,,0,0,0,0,0,0,,,,,,,,,0,0,0.00%,0,0.045,0.045,,,,
Jack Campbell,EDM,G,26,0,1,1,2,,,,,,0,0,0,0,0,0,,,,,,,,,0,0,0.00%,0,0.038,0.038,,,,
Jake Allen,MTL,G,29,0,1,1,0,,,,,,0,0,0,0,0,0,,,,,,,,,0,0,0.00%,0,0.034,0.034,,,,
Stuart Skinner,EDM,G,29,0,1,1,0,,,,,,0,0,0,0,0,0,,,,,,,,,0,0,0.00%,0,0.034,0.034,,,,
Marc-Andre Fleury,MIN,G,33,0,1,1,0,,,,,,0,0,0,0,0,0,,,,,,,,,0,0,0.00%,0,0.03,0.03,,,,
Vitek Vanecek,NJD,G,33,0,1,1,2,,,,,,0,0,0,0,0,0,,,,,,,,,0,0,0.00%,0,0.03,0.03,,,,
Jacob Markström,CGY,G,34,0,1,1,12,,,,,,0,0,0,0,0,0,,,,,,,,,0,0,0.00%,0,0.029,0.029,,,,
Alexandar Georgiev,COL,G,35,0,1,1,0,,,,,,0,0,0,0,0,0,,,,,,,,,0,0,0.00%,0,0.029,0.029,,,,
Andrei Vasilevski,TBL,G,38,0,1,1,0,,,,,,0,0,0,0,0,0,,,,,,,,,0,0,0.00%,0,0.026,0.026,,,,
Jordan Binnington,STL,G,39,0,1,1,10,,,,,,0,0,0,0,0,0,,,,,,,,,0,0,0.00%,0,0.026,0.026,,,,
Jake Oettinger,DAL,G,40,0,1,1,2,,,,,,0,0,0,0,0,0,,,,,,,,,0,0,0.00%,0,0.025,0.025,,,,
Keith Kinkaid,BOS,G,1,0,0,0,0,,,,,,0,0,0,0,0,0,,,,,,,,,0,0,0.00%,0,0,0,,,,
Cole Bardreau,NYI,W,1,0,0,0,2,0,6:37,6:37,0:00,0:00,0,0,0,0,0,0,0,0,0,0,0,0,0,0,0,0,0.00%,0,0,0,0,0.00%,2,0
Jonas Johansson,COL,G,1,0,0,0,0,,,,,,0,0,0,0,0,0,,,,,,,,,0,0,0.00%,0,0,0,,,,
Buddy Robinson,CHI,W,1,0,0,0,0,-1,11:03,9:59,0:00,1:04,0,0,0,0,0,0,0,0,0,0,0,0,0,0,0,0,0.00%,0,0,0,0,0.00%,3,0
Chris Wagner,BOS,W,1,0,0,0,0,0,12:36,11:49,0:00,0:47,0,0,0,0,0,0,0,0,0,0,0,0,0,0,0,0,0.00%,0,0,0,0,0.00%,6,1
Ondrej Kase,CAR,W,1,0,0,0,0,0,11:02,9:08,1:13,0:41,0,0,0,0,0,0,0,0,0,0,0,0,0,0,0,0,0.00%,0,0,0,0,0.00%,1,0
Jean-Sebastien Dea,ARI,W,1,0,0,0,0,-1,7:41,7:41,0:00,0:00,0,0,0,0,0,0,0,0,0,0,0,0,0,0,0,0,0.00%,0,0,0,1,0.00%,1,1
Anders Bjork,BUF,W,1,0,0,0,0,0,9:38,9:38,0:00,0:00,0,0,0,0,0,0,0,0,0,0,0,0,0,0,0,0,0.00%,0,0,0,1,0.00%,0,0
Lias Andersson,LAK,C,1,0,0,0,0,-1,8:37,8:37,0:00,0:00,0,0,0,0,0,0,0,0,0,0,0,0,0,0,0,0,0.00%,0,0,0,1,0.00%,2,0
Jeffrey Truchon-Viel,SJS,W,1,0,0,0,2,0,7:22,7:22,0:00,0:00,0,0,0,0,0,0,0,0,0,0,0,0,0,0,0,0,0.00%,0,0,0,1,0.00%,2,1
Alex Barre-Boulet,TBL,W,1,0,0,0,0,0,10:01,9:55,0:00,0:06,0,0,0,0,0,0,0,0,0,0,0,0,0,0,0,0,0.00%,0,0,0,1,0.00%,0,0
Dan Renouf,BOS,D,1,0,0,0,0,-3,11:34,10:49,0:00,0:45,0,0,0,0,0,0,0,0,0,0,0,0,0,0,0,0,0.00%,0,0,0,5,0.00%,1,2
Marian Studenic,DAL,W,1,0,0,0,0,0,8:12,8:12,0:00,0:00,0,0,0,0,0,0,0,0,0,0,0,0,0,0,0,0,0.00%,0,0,0,4,0.00%,1,0
Dylan Wells,CHI,G,1,0,0,0,0,,,,,,0,0,0,0,0,0,,,,,,,,,0,0,0.00%,0,0,0,,,,
Hayden Hodgson,PHI,W,1,0,0,0,0,0,4:46,4:46,0:00,0:00,0,0,0,0,0,0,0,0,0,0,0,0,0,0,0,0,0.00%,0,0,0,0,0.00%,0,0
Matthew Berlin,EDM,G,1,0,0,0,0,,,,,,0,0,0,0,0,0,,,,,,,,,0,0,0.00%,0,0,0,,,,
Joel Daccord,SEA,G,1,0,0,0,0,,,,,,0,0,0,0,0,0,,,,,,,,,0,0,0.00%,0,0,0,,,,
Jeremy Davies,BUF,D,1,0,0,0,2,0,8:33,8:33,0:00,0:00,0,0,0,0,0,0,0,0,0,0,0,0,0,0,0,0,0.00%,0,0,0,1,0.00%,0,1
Cayden Primeau,MTL,G,1,0,0,0,0,,,,,,0,0,0,0,0,0,,,,,,,,,0,0,0.00%,0,0,0,,,,
Jacob Peterson,DAL,W,1,0,0,0,0,-2,12:19,12:16,0:03,0:00,0,0,0,0,0,0,0,0,0,0,0,0,0,0,0,0,0.00%,0,0,0,1,0.00%,0,1
Gabriel Fortier,TBL,W,1,0,0,0,0,0,8:25,8:25,0:00,0:00,0,0,0,0,0,0,0,0,0,0,0,0,0,0,0,0,0.00%,0,0,0,0,0.00%,1,0
Semyon Der-Arguchintsev,TOR,C,1,0,0,0,0,1,7:16,6:22,0:54,0:00,0,0,0,0,0,0,0,0,0,0,0,0,0,0,0,0,0.00%,0,0,0,0,0.00%,0,0
Shane Bowers,COL,W,1,0,0,0,0,0,1:46,1:46,0:00,0:00,0,0,0,0,0,0,0,0,0,0,0,0,0,0,0,0,0.00%,0,0,0,1,0.00%,0,0
Oskar Olausson,COL,W,1,0,0,0,0,0,7:02,7:02,0:00,0:00,0,0,0,0,0,0,0,0,0,0,0,0,0,0,0,0,0.00%,0,0,0,0,0.00%,0,0
Milos Kelemen,ARI,W,1,0,0,0,0,0,10:04,8:28,0:00,1:36,0,0,0,0,0,0,0,0,0,0,0,0,0,0,0,0,0.00%,0,0,0,1,0.00%,3,0
Jan Jenik,ARI,W,1,0,0,0,4,0,3:59,3:53,0:06,0:00,0,0,0,0,0,0,0,0,0,0,0,0,0,0,0,0,0.00%,0,0,0,0,0.00%,2,1
C.J. Suess,SJS,W,1,0,0,0,2,-1,5:50,5:50,0:00,0:00,0,0,0,0,0,0,0,0,0,0,0,0,0,0,0,0,0.00%,0,0,0,0,0.00%,1,0
Alexander Steeves,TOR,W,1,0,0,0,0,0,10:06,9:58,0:08,0:00,0,0,0,0,0,0,0,0,0,0,0,0,0,0,0,0,0.00%,0,0,0,2,0.00%,2,0
Sheldon Rempal,VGK,W,1,0,0,0,0,-2,7:44,7:44,0:00,0:00,0,0,0,0,0,0,0,0,0,0,0,0,0,0,0,0,0.00%,0,0,0,0,0.00%,0,0
Yaroslav Askarov,NSH,G,1,0,0,0,0,,,,,,0,0,0,0,0,0,,,,,,,,,0,0,0.00%,0,0,0,,,,
William Dufour,NYI,W,1,0,0,0,0,-2,6:48,6:48,0:00,0:00,0,0,0,0,0,0,0,0,0,0,0,0,0,0,0,0,0.00%,0,0,0,0,0.00%,1,0
Owen Beck,MTL,W,1,0,0,0,0,-1,9:48,9:39,0:09,0:00,0,0,0,0,0,0,0,0,0,0,0,0,0,0,0,0,0.00%,0,0,0,0,0.00%,0,1
Dustin Tokarski,PIT,G,2,0,0,0,0,,,,,,0,0,0,0,0,0,,,,,,,,,0,0,0.00%,0,0,0,,,,
Riley Sheahan,BUF,W,2,0,0,0,4,-2,8:18,8:08,0:00,0:10,0,0,0,0,0,0,0,0,0,0,0,0,0,0,0,0,0.00%,0,0,0,0,0.00%,0,1
Andreas Johnson,NJD,W,2,0,0,0,0,0,4:44,4:44,0:00,0:00,0,0,0,0,0,0,0,0,0,0,0,0,0,0,0,0,0.00%,0,0,0,1,0.00%,0,0
Aaron Dell,SJS,G,2,0,0,0,0,,,,,,0,0,0,0,0,0,,,,,,,,,0,0,0.00%,0,0,0,,,,
Lucas Carlsson,FLA,D,2,0,0,0,2,-1,10:05,9:45,0:00,0:20,0,0,0,0,0,0,0,0,0,0,0,0,0,0,0,0,0.00%,0,0,0,2,0.00%,3,1
Tyler Benson,EDM,W,2,0,0,0,0,0,6:17,6:02,0:15,0:00,0,0,0,0,0,0,0,0,0,0,0,0,0,0,0,0,0.00%,0,0,0,0,0.00%,2,0
Anton Levtchi,FLA,W,2,0,0,0,0,0,9:34,9:14,0:20,0:00,0,0,0,0,0,0,0,0,0,0,0,0,0,0,0,0,0.00%,0,0,0,1,0.00%,0,0
Jacob Moverare,LAK,D,2,0,0,0,0,-1,14:58,14:58,0:00,0:00,0,0,0,0,0,0,0,0,0,0,0,0,0,0,0,0,0.00%,0,0,0,6,0.00%,3,4
Steven Fogarty,MIN,W,2,0,0,0,0,0,10:19,9:39,0:40,0:00,0,0,0,0,0,0,0,0,0,0,0,0,0,0,0,0,0.00%,0,0,0,0,0.00%,3,0
Noah Juulsen,VAN,D,2,0,0,0,0,-1,11:03,10:51,0:00,0:12,0,0,0,0,0,0,0,0,0,0,0,0,0,0,0,0,0.00%,0,0,0,1,0.00%,4,3
Lucas Johansen,WSH,D,2,0,0,0,0,0,12:39,12:39,0:00,0:00,0,0,0,0,0,0,0,0,0,0,0,0,0,0,0,0,0.00%,0,0,0,3,0.00%,0,3
Matthew Phillips,CGY,W,2,0,0,0,2,0,9:02,6:11,2:50,0:00,0,0,0,0,0,0,0,0,0,0,0,0,0,0,0,0,0.00%,0,0,0,1,0.00%,0,0
Brett Seney,CHI,W,2,0,0,0,0,0,15:16,14:29,0:47,0:00,0,0,0,0,0,0,0,0,0,0,0,0,0,0,0,0,0.00%,0,0,0,0,0.00%,5,1
Dennis Cholowski,NYI,D,2,0,0,0,0,-1,12:46,10:29,2:17,0:00,0,0,0,0,0,0,0,0,0,0,0,0,0,0,0,0,0.00%,0,0,0,0,0.00%,0,1
Filip Kral,TOR,D,2,0,0,0,2,0,9:57,9:01,0:00,0:56,0,0,0,0,0,0,0,0,0,0,0,0,0,0,0,0,0.00%,0,0,0,1,0.00%,2,1
Eetu Mäkiniemi,SJS,G,2,0,0,0,0,,,,,,0,0,0,0,0,0,,,,,,,,,0,0,0.00%,0,0,0,,,,
Filip Hållander,PIT,W,2,0,0,0,0,0,9:58,7:51,0:00,2:06,0,0,0,0,0,0,0,0,0,0,0,0,0,0,0,0,0.00%,0,0,0,0,0.00%,1,3
Lassi Thomson,OTT,D,2,0,0,0,4,-2,10:53,10:48,0:05,0:00,0,0,0,0,0,0,0,0,0,0,0,0,0,0,0,0,0.00%,0,0,0,1,0.00%,2,0
Marc McLaughlin,BOS,W,2,0,0,0,2,-1,10:03,8:46,0:51,0:26,0,0,0,0,0,0,0,0,0,0,0,0,0,0,0,0,0.00%,0,0,0,3,0.00%,2,0
Tyce Thompson,NJD,W,2,0,0,0,0,-1,8:39,8:39,0:00,0:00,0,0,0,0,0,0,0,0,0,0,0,0,0,0,0,0,0.00%,0,0,0,1,0.00%,0,2
Callahan Burke,COL,W,2,0,0,0,0,-1,8:48,8:30,0:00,0:18,0,0,0,0,0,0,0,0,0,0,0,0,0,0,0,0,0.00%,0,0,0,2,0.00%,1,2
David Jiricek,CBJ,D,2,0,0,0,2,-4,15:30,14:40,0:50,0:00,0,0,0,0,0,0,0,0,0,0,0,0,0,0,0,0,0.00%,0,0,0,4,0.00%,5,4
Nikita Soshnikov,NYI,W,3,0,0,0,0,-2,9:56,9:06,0:00,0:50,0,0,0,0,0,0,0,0,0,0,0,0,0,0,0,0,0.00%,0,0,0,4,0.00%,8,0
Gustav Olofsson,SEA,D,3,0,0,0,0,1,12:56,12:07,0:03,0:45,0,0,0,0,0,0,0,0,0,0,0,0,0,0,0,0,0.00%,0,0,0,6,0.00%,2,4
Jacob Larsson,OTT,D,3,0,0,0,4,-1,12:46,12:35,0:00,0:10,0,0,0,0,0,0,0,0,0,0,0,0,0,0,0,0,0.00%,0,0,0,2,0.00%,3,2
Laurent Dauphin,ARI,C,3,0,0,0,2,-1,9:05,8:57,0:00,0:07,0,0,0,0,0,0,0,0,0,0,0,0,0,0,0,0,0.00%,0,0,0,5,0.00%,1,1
Dillon Heatherington,OTT,D,3,0,0,0,0,-3,9:16,9:12,0:00,0:03,0,0,0,0,0,0,0,0,0,0,0,0,0,0,0,0,0.00%,0,0,0,1,0.00%,2,2
Glenn Gawdin,ANA,W,3,0,0,0,0,-1,9:35,7:17,0:37,1:40,0,0,0,0,0,0,0,0,0,0,0,0,0,0,0,0,0.00%,0,0,0,3,0.00%,4,3
Maxime Lajoie,CAR,D,3,0,0,0,0,0,7:51,7:44,0:03,0:04,0,0,0,0,0,0,0,0,0,0,0,0,0,0,0,0,0.00%,0,0,0,2,0.00%,2,0
Drake Caggiula,PIT,W,3,0,0,0,0,-1,7:27,7:27,0:00,0:00,0,0,0,0,0,0,0,0,0,0,0,0,0,0,0,0,0.00%,0,0,0,2,0.00%,5,1
Riley Tufte,DAL,W,3,0,0,0,0,-1,7:57,7:57,0:00,0:00,0,0,0,0,0,0,0,0,0,0,0,0,0,0,0,0,0.00%,0,0,0,1,0.00%,6,0
Nolan Foote,NJD,W,3,0,0,0,0,0,6:59,6:59,0:00,0:00,0,0,0,0,0,0,0,0,0,0,0,0,0,0,0,0,0.00%,0,0,0,1,0.00%,3,1
Olle Lycksell,PHI,W,3,0,0,0,2,0,9:36,9:36,0:00,0:00,0,0,0,0,0,0,0,0,0,0,0,0,0,0,0,0,0.00%,0,0,0,2,0.00%,1,2
Pavel Dorofeyev,VGK,W,3,0,0,0,2,0,11:42,9:51,1:51,0:00,0,0,0,0,0,0,0,0,0,0,0,0,0,0,0,0,0.00%,0,0,0,5,0.00%,0,1
Johnny Gruden,PIT,C,3,0,0,0,0,0,5:19,4:51,0:00,0:28,0,0,0,0,0,0,0,0,0,0,0,0,0,0,0,0,0.00%,0,0,0,0,0.00%,4,1
Jaxson Stauber,CHI,G,3,0,0,0,0,,,,,,0,0,0,0,0,0,,,,,,,,,0,0,0.00%,0,0,0,,,,
Josh Dunne,CBJ,C,3,0,0,0,0,-1,5:43,5:43,0:00,0:00,0,0,0,0,0,0,0,0,0,0,0,0,0,0,0,0,0.00%,0,0,0,0,0.00%,3,0
Jordan Spence,LAK,D,3,0,0,0,0,0,14:18,14:00,0:00,0:18,0,0,0,0,0,0,0,0,0,0,0,0,0,0,0,0,0.00%,0,0,0,4,0.00%,2,3
Mark Borowiecki,NSH,D,4,0,0,0,12,0,9:55,8:46,0:00,1:08,0,0,0,0,0,0,0,0,0,0,0,0,0,0,0,0,0.00%,0,0,0,1,0.00%,5,1
Alex Galchenyuk,COL,W,4,0,0,0,4,-3,9:49,8:45,1:04,0:00,0,0,0,0,0,0,0,0,0,0,0,0,0,0,0,0,0.00%,0,0,0,2,0.00%,4,2
Connor Brown,WSH,W,4,0,0,0,0,-3,16:46,13:04,1:37,2:03,0,0,0,0,0,0,0,0,0,0,0,0,0,0,0,0,0.00%,0,0,0,2,0.00%,6,1
Trey Fix-Wolansky,CBJ,W,4,0,0,0,0,0,9:56,9:17,0:39,0:00,0,0,0,0,0,0,0,0,0,0,0,0,0,0,0,0,0.00%,0,0,0,6,0.00%,5,4
Nick DeSimone,CGY,D,4,0,0,0,2,-4,11:15,10:28,0:03,0:43,0,0,0,0,0,0,0,0,0,0,0,0,0,0,0,0,0.00%,0,0,0,4,0.00%,2,4
Alex Turcotte,LAK,C,4,0,0,0,5,-2,6:58,6:58,0:00,0:00,0,0,0,0,0,0,0,0,0,0,0,0,0,0,0,0,0.00%,0,0,0,2,0.00%,1,0
Alec Regula,CHI,D,4,0,0,0,4,-3,16:35,14:26,1:54,0:15,0,0,0,0,0,0,0,0,0,0,0,0,0,0,0,0,0.00%,0,0,0,2,0.00%,4,8
Will Cuylle,NYR,W,4,0,0,0,10,-2,6:57,6:54,0:03,0:00,0,0,0,0,0,0,0,0,0,0,0,0,0,0,0,0,0.00%,0,0,0,1,0.00%,8,0
Darren Helm,COL,W,5,0,0,0,0,-4,9:28,7:44,0:00,1:44,0,0,0,0,0,0,0,0,0,0,0,0,0,0,0,0,0.00%,0,0,0,3,0.00%,10,1
Mikhail Maltsev,COL,W,5,0,0,0,0,0,6:35,6:35,0:00,0:00,0,0,0,0,0,0,0,0,0,0,0,0,0,0,0,0,0.00%,0,0,0,4,0.00%,4,2
Austin Strand,ANA,D,5,0,0,0,2,-2,12:24,12:23,0:00,0:00,0,0,0,0,0,0,0,0,0,0,0,0,0,0,0,0,0.00%,0,0,0,5,0.00%,5,4
Jackson Cates,PHI,W,5,0,0,0,0,0,8:58,8:56,0:02,0:00,0,0,0,0,0,0,0,0,0,0,0,0,0,0,0,0,0.00%,0,0,0,4,0.00%,3,1
Kevin Gravel,NSH,D,6,0,0,0,0,-5,14:01,12:46,0:00,1:15,0,0,0,0,0,0,0,0,0,0,0,0,0,0,0,0,0.00%,0,0,0,6,0.00%,10,9
Roland McKeown,NSH,D,6,0,0,0,8,1,12:58,12:12,0:00,0:46,0,0,0,0,0,0,0,0,0,0,0,0,0,0,0,0,0.00%,0,0,0,3,0.00%,4,6
Rourke Chartier,OTT,W,6,0,0,0,0,0,10:20,8:43,0:03,1:33,0,0,0,0,0,0,0,0,0,0,0,0,0,0,0,0,0.00%,0,0,0,8,0.00%,10,3
Samuel Ersson,PHI,G,6,0,0,0,0,,,,,,0,0,0,0,0,0,,,,,,,,,0,0,0.00%,0,0,0,,,,
Alex Lyon,FLA,G,6,0,0,0,0,,,,,,0,0,0,0,0,0,,,,,,,,,0,0,0.00%,0,0,0,,,,
Sampo Ranta,COL,W,6,0,0,0,4,0,7:20,7:20,0:00,0:00,0,0,0,0,0,0,0,0,0,0,0,0,0,0,0,0,0.00%,0,0,0,5,0.00%,10,3
Connor McMichael,WSH,W,6,0,0,0,5,0,8:51,8:50,0:00,0:00,0,0,0,0,0,0,0,0,0,0,0,0,0,0,0,0,0.00%,0,0,0,2,0.00%,2,3
Adam Beckman,MIN,W,6,0,0,0,0,-2,10:08,9:42,0:26,0:00,0,0,0,0,0,0,0,0,0,0,0,0,0,0,0,0,0.00%,0,0,0,9,0.00%,2,1
Jakob Pelletier,CGY,W,6,0,0,0,0,-1,12:33,10:31,2:01,0:00,0,0,0,0,0,0,0,0,0,0,0,0,0,0,0,0,0.00%,0,0,0,10,0.00%,2,2
Justin Kirkland,ANA,W,7,0,0,0,0,-3,7:12,7:12,0:00,0:00,0,0,0,0,0,0,0,0,0,0,0,0,0,0,0,0,0.00%,0,0,0,5,0.00%,8,3
Lukas Dostal,ANA,G,7,0,0,0,0,,,,,,0,0,0,0,0,0,,,,,,,,,0,0,0.00%,0,0,0,,,,
Anton Strålman,BOS,D,8,0,0,0,2,-3,15:22,14:27,0:00,0:54,0,0,0,0,0,0,0,0,0,0,0,0,0,0,0,0,0.00%,0,0,0,3,0.00%,12,10
Radim Zohorna,CGY,W,8,0,0,0,0,-2,8:25,7:50,0:34,0:00,0,0,0,0,0,0,0,0,0,0,0,0,0,0,0,0,0.00%,0,0,0,3,0.00%,5,1
Bobby McMann,TOR,C,8,0,0,0,2,-3,10:58,10:44,0:14,0:00,0,0,0,0,0,0,0,0,0,0,0,0,0,0,0,0,0.00%,0,0,0,17,0.00%,15,0
Jamie Drysdale,ANA,D,8,0,0,0,2,-3,17:37,16:10,0:34,0:52,0,0,0,0,0,0,0,0,0,0,0,0,0,0,0,0,0.00%,0,0,0,8,0.00%,7,6
Magnus Hellberg,DET,G,9,0,0,0,0,,,,,,0,0,0,0,0,0,,,,,,,,,0,0,0.00%,0,0,0,,,,
Charles Hudon,COL,W,9,0,0,0,2,-2,10:46,9:52,0:53,0:00,0,0,0,0,0,0,0,0,0,0,0,0,0,0,0,0,0.00%,0,0,0,18,0.00%,13,2
Alexander Nedeljkovic,DET,G,9,0,0,0,2,,,,,,0,0,0,0,0,0,,,,,,,,,0,0,0.00%,0,0,0,,,,
Maxwell Willman,PHI,W,9,0,0,0,4,-3,8:57,8:57,0:00,0:00,0,0,0,0,0,0,0,0,0,0,0,0,0,0,0,0,0.00%,0,0,0,9,0.00%,16,6
Akira Schmid,NJD,G,9,0,0,0,0,,,,,,0,0,0,0,0,0,,,,,,,,,0,0,0.00%,0,0,0,,,,
Jean-Luc Foudy,COL,W,9,0,0,0,6,-3,10:01,9:16,0:45,0:00,0,0,0,0,0,0,0,0,0,0,0,0,0,0,0,0,0.00%,0,0,0,12,0.00%,2,2
Brad Malone,EDM,W,10,0,0,0,6,-4,7:41,6:28,0:04,1:07,0,0,0,0,0,0,0,0,0,0,0,0,0,0,0,0,0.00%,0,0,0,7,0.00%,26,4
Felix Sandström,PHI,G,10,0,0,0,0,,,,,,0,0,0,0,0,0,,,,,,,,,0,0,0.00%,0,0,0,,,,
James Hamblin,EDM,W,10,0,0,0,2,-3,8:51,8:05,0:06,0:39,0,0,0,0,0,0,0,0,0,0,0,0,0,0,0,0,0.00%,0,0,0,12,0.00%,2,1
Erik Källgren,TOR,G,10,0,0,0,0,,,,,,0,0,0,0,0,0,,,,,,,,,0,0,0.00%,0,0,0,,,,
Cal Petersen,LAK,G,10,0,0,0,0,,,,,,0,0,0,0,0,0,,,,,,,,,0,0,0.00%,0,0,0,,,,
Kevin Lankinen,NSH,G,11,0,0,0,0,,,,,,0,0,0,0,0,0,,,,,,,,,0,0,0.00%,0,0,0,,,,
Joel Hanley,DAL,D,13,0,0,0,15,5,11:50,11:44,0:01,0:05,0,0,0,0,0,0,0,0,0,0,0,0,0,0,0,0,0.00%,0,0,0,9,0.00%,13,17
David Rittich,WPG,G,13,0,0,0,2,,,,,,0,0,0,0,0,0,,,,,,,,,0,0,0.00%,0,0,0,,,,
Dysin Mayo,ARI,D,13,0,0,0,6,-7,11:57,10:37,0:01,1:19,0,0,0,0,0,0,0,0,0,0,0,0,0,0,0,0,0.00%,0,0,0,6,0.00%,28,18
Daniil Tarasov,CBJ,G,13,0,0,0,0,,,,,,0,0,0,0,0,0,,,,,,,,,0,0,0.00%,0,0,0,,,,
Carson Meyer,CBJ,C,13,0,0,0,4,-2,9:34,9:17,0:13,0:02,0,0,0,0,0,0,0,0,0,0,0,0,0,0,0,0,0.00%,0,0,0,16,0.00%,22,6
Jaroslav Halak,NYR,G,14,0,0,0,0,,,,,,0,0,0,0,0,0,,,,,,,,,0,0,0.00%,0,0,0,,,,
Alex Stalock,CHI,G,14,0,0,0,4,,,,,,0,0,0,0,0,0,,,,,,,,,0,0,0.00%,0,0,0,,,,
Anton Blidh,COL,W,14,0,0,0,4,-2,6:34,6:34,0:00,0:00,0,0,0,0,0,0,0,0,0,0,0,0,0,0,0,0,0.00%,0,0,0,9,0.00%,18,2
Thomas Greiss,STL,G,15,0,0,0,0,,,,,,0,0,0,0,0,0,,,,,,,,,0,0,0.00%,0,0,0,,,,
Frederik Andersen,CAR,G,15,0,0,0,0,,,,,,0,0,0,0,0,0,,,,,,,,,0,0,0.00%,0,0,0,,,,
Thatcher Demko,VAN,G,15,0,0,0,4,,,,,,0,0,0,0,0,0,,,,,,,,,0,0,0.00%,0,0,0,,,,
Mackenzie Blackwood,NJD,G,15,0,0,0,2,,,,,,0,0,0,0,0,0,,,,,,,,,0,0,0.00%,0,0,0,,,,
Arvid Söderblom,CHI,G,15,0,0,0,0,,,,,,0,0,0,0,0,0,,,,,,,,,0,0,0.00%,0,0,0,,,,
Scott Wedgewood,DAL,G,16,0,0,0,0,,,,,,0,0,0,0,0,0,,,,,,,,,0,0,0.00%,0,0,0,,,,
Semyon Varlamov,NYI,G,17,0,0,0,0,,,,,,0,0,0,0,0,0,,,,,,,,,0,0,0.00%,0,0,0,,,,
Connor Ingram,ARI,G,17,0,0,0,2,,,,,,0,0,0,0,0,0,,,,,,,,,0,0,0.00%,0,0,0,,,,
Philipp Grubauer,SEA,G,18,0,0,0,0,,,,,,0,0,0,0,0,0,,,,,,,,,0,0,0.00%,0,0,0,,,,
Matt Murray,TOR,G,18,0,0,0,0,,,,,,0,0,0,0,0,0,,,,,,,,,0,0,0.00%,0,0,0,,,,
Antti Raanta,CAR,G,19,0,0,0,0,,,,,,0,0,0,0,0,0,,,,,,,,,0,0,0.00%,0,0,0,,,,
Anthony Stolarz,ANA,G,19,0,0,0,0,,,,,,0,0,0,0,0,0,,,,,,,,,0,0,0.00%,0,0,0,,,,
Pyotr Kochetkov,CAR,G,19,0,0,0,0,,,,,,0,0,0,0,0,0,,,,,,,,,0,0,0.00%,0,0,0,,,,
Daniel Vladar,CGY,G,20,0,0,0,2,,,,,,0,0,0,0,0,0,,,,,,,,,0,0,0.00%,0,0,0,,,,
Elvis Merzlikins,CBJ,G,21,0,0,0,4,,,,,,0,0,0,0,0,0,,,,,,,,,0,0,0.00%,0,0,0,,,,
Ukko-Pekka Luukkonen,BUF,G,21,0,0,0,0,,,,,,0,0,0,0,0,0,,,,,,,,,0,0,0.00%,0,0,0,,,,
Jeremy Swayman,BOS,G,21,0,0,0,0,,,,,,0,0,0,0,0,0,,,,,,,,,0,0,0.00%,0,0,0,,,,
Kaapo Kähkönen,SJS,G,22,0,0,0,0,,,,,,0,0,0,0,0,0,,,,,,,,,0,0,0.00%,0,0,0,,,,
Samuel Montembeault,MTL,G,22,0,0,0,0,,,,,,0,0,0,0,0,0,,,,,,,,,0,0,0.00%,0,0,0,,,,
Markus Niemeläinen,EDM,D,23,0,0,0,4,3,10:02,9:14,0:01,0:46,0,0,0,0,0,0,0,0,0,0,0,0,0,0,0,0,0.00%,0,0,0,16,0.00%,61,16
Charlie Lindgren,WSH,G,23,0,0,0,0,,,,,,0,0,0,0,0,0,,,,,,,,,0,0,0.00%,0,0,0,,,,
Joonas Korpisalo,CBJ,G,24,0,0,0,0,,,,,,0,0,0,0,0,0,,,,,,,,,0,0,0.00%,0,0,0,,,,
Casey DeSmith,PIT,G,24,0,0,0,2,,,,,,0,0,0,0,0,0,,,,,,,,,0,0,0.00%,0,0,0,,,,
Jonathan Quick,LAK,G,27,0,0,0,2,,,,,,0,0,0,0,0,0,,,,,,,,,0,0,0.00%,0,0,0,,,,
Anton Forsberg,OTT,G,27,0,0,0,2,,,,,,0,0,0,0,0,0,,,,,,,,,0,0,0.00%,0,0,0,,,,
James Reimer,SJS,G,28,0,0,0,0,,,,,,0,0,0,0,0,0,,,,,,,,,0,0,0.00%,0,0,0,,,,
Cameron Talbot,OTT,G,28,0,0,0,0,,,,,,0,0,0,0,0,0,,,,,,,,,0,0,0.00%,0,0,0,,,,
Spencer Martin,VAN,G,28,0,0,0,0,,,,,,0,0,0,0,0,0,,,,,,,,,0,0,0.00%,0,0,0,,,,
Jake Leschyshyn,NYR,C,30,0,0,0,8,-8,9:12,9:01,0:01,0:10,0,0,0,0,0,0,0,0,0,0,0,0,0,0,0,0,0.00%,0,0,0,27,0.00%,46,9
Sergei Bobrovsky,FLA,G,31,0,0,0,0,,,,,,0,0,0,0,0,0,,,,,,,,,0,0,0.00%,0,0,0,,,,
Linus Ullmark,BOS,G,33,0,0,0,2,,,,,,0,0,0,0,0,0,,,,,,,,,0,0,0.00%,0,0,0,,,,
Justin Braun,PHI,D,34,0,0,0,19,1,16:03,14:14,0:02,1:46,0,0,0,0,0,0,0,0,0,0,0,0,0,0,0,0,0.00%,0,0,0,28,0.00%,34,35
Darcy Kuemper,WSH,G,34,0,0,0,4,,,,,,0,0,0,0,0,0,,,,,,,,,0,0,0.00%,0,0,0,,,,
Ville Husso,DET,G,36,0,0,0,0,,,,,,0,0,0,0,0,0,,,,,,,,,0,0,0.00%,0,0,0,,,,
Karel Vejmelka,ARI,G,36,0,0,0,2,,,,,,0,0,0,0,0,0,,,,,,,,,0,0,0.00%,0,0,0,,,,
Logan Thompson,VGK,G,36,0,0,0,2,,,,,,0,0,0,0,0,0,,,,,,,,,0,0,0.00%,0,0,0,,,,
Martin Jones,SEA,G,37,0,0,0,0,,,,,,0,0,0,0,0,0,,,,,,,,,0,0,0.00%,0,0,0,,,,
Juuse Saros,NSH,G,38,0,0,0,0,,,,,,0,0,0,0,0,0,,,,,,,,,0,0,0.00%,0,0,0,,,,
Igor Shesterkin,NYR,G,38,0,0,0,0,,,,,,0,0,0,0,0,0,,,,,,,,,0,0,0.00%,0,0,0,,,,
Carter Hart,PHI,G,39,0,0,0,0,,,,,,0,0,0,0,0,0,,,,,,,,,0,0,0.00%,0,0,0,,,,
Ilya Sorokin,NYI,G,40,0,0,0,0,,,,,,0,0,0,0,0,0,,,,,,,,,0,0,0.00%,0,0,0,,,,
Connor Hellebuyck,WPG,G,40,0,0,0,0,,,,,,0,0,0,0,0,0,,,,,,,,,0,0,0.00%,0,0,0,,,,